# Gboard Dictionary version:1
ahalimushenzhang	阿哈利姆神杖	zh-CN
atuosizhigun	阿托斯之棍	zh-CN
azijialuo	阿兹加洛	zh-CN
aiou	埃欧	zh-CN
airenzhishengji	矮人直升机	zh-CN
airuida	艾瑞达	zh-CN
anmie	暗灭	zh-CN
anmu	暗牧	zh-CN
ansha	暗杀	zh-CN
anyanshu	暗言术	zh-CN
anyemowang	暗夜魔王	zh-CN
anyingbo	暗影波	zh-CN
anyingbu	暗影步	zh-CN
anyingchongci	暗影冲刺	zh-CN
anyingemo	暗影恶魔	zh-CN
anyinghufu	暗影护符	zh-CN
anyingjudu	暗影剧毒	zh-CN
anyingmushi	暗影牧师	zh-CN
anyingsaman	暗影萨满	zh-CN
anyingtuxi	暗影突袭	zh-CN
anyingzhiwu	暗影之舞	zh-CN
aoshuguanghuan	奥术光环	zh-CN
aoshushenfu	奥术神符	zh-CN
aoshutianqiu	奥术天球	zh-CN
aoshuxie	奥术鞋	zh-CN
aoshuzuzhou	奥术诅咒	zh-CN
baba	爸爸	zh-CN
balana	巴拉那	zh-CN
balasen	巴拉森	zh-CN
baihu	白虎	zh-CN
bainiu	白牛	zh-CN
baiyinzhifeng	白银之锋	zh-CN
banjia	板甲	zh-CN
banrenmaxingzhe	半人马行者	zh-CN
banrenmengma	半人猛犸	zh-CN
banrenxiniu	半人犀牛	zh-CN
baotou	爆头	zh-CN
beici	背刺	zh-CN
beienhuole	贝恩霍勒	zh-CN
benteng	奔腾	zh-CN
benxichongzhuang	奔袭冲撞	zh-CN
bengliejingu	崩裂禁锢	zh-CN
bizhang	臂章	zh-CN
biandan	变蛋	zh-CN
bianfuqishi	蝙蝠骑士	zh-CN
biantigongji	变体攻击	zh-CN
biantijingling	变体精灵	zh-CN
bianxing	变形	zh-CN
bianxingshu	变形术	zh-CN
bianzhi	编织	zh-CN
bianzhizhe	编织者	zh-CN
biaoji	标记	zh-CN
biaoqiang	标枪	zh-CN
bintiezhizhao	镔铁之爪	zh-CN
bingfengjinzhi	冰封禁制	zh-CN
bingfenglujing	冰封路径	zh-CN
bingfengmoyin	冰封魔印	zh-CN
binghun	冰魂	zh-CN
binghuojiaojia	冰火交加	zh-CN
bingjia	冰甲	zh-CN
bingjian	冰箭	zh-CN
bingjingbaohong	冰晶爆轰	zh-CN
binglie	并列	zh-CN
binglong	冰龙	zh-CN
bingnv	冰女	zh-CN
bingqiang	冰墙	zh-CN
bingshuangxinxing	冰霜新星	zh-CN
bingshuangxuanwo	冰霜漩涡	zh-CN
bingyan	冰眼	zh-CN
bolangxingtai	波浪形态	zh-CN
bozang	薄葬	zh-CN
bukeqinfan	不可侵犯	zh-CN
bulandewadeng	布兰德瓦登	zh-CN
buwendingdianliu	不稳定电流	zh-CN
buwendinghuahewu	不稳定化合物	zh-CN
buxiushiwang	不朽尸王	zh-CN
buxiushouhu	不朽守护	zh-CN
canshi	残石	zh-CN
canyan	残焰	zh-CN
canying	残影	zh-CN
cangqiongzhenji	苍穹震击	zh-CN
caoxie	草鞋	zh-CN
chakelamofa	查克拉魔法	zh-CN
chaita	拆塔	zh-CN
chaofuhe	超负荷	zh-CN
chaoqiangliliang	超强力量	zh-CN
chaoshengchongjibo	超声冲击波	zh-CN
chaoxi	潮汐	zh-CN
chaoxilieren	潮汐猎人	zh-CN
chaoxishizhe	潮汐使者	zh-CN
chaoxinxing	超新星	zh-CN
chaozhenshengbo	超震声波	zh-CN
chenmomofa	沉默魔法	zh-CN
chenmoshushi	沉默术士	zh-CN
chihongjia	赤红甲	zh-CN
chihun	炽魂	zh-CN
chongci	冲刺	zh-CN
chongjibo	冲击波	zh-CN
chongqun	虫群	zh-CN
chongsheng	重生	zh-CN
chufaxianjing	触发陷阱	zh-CN
chuanci	穿刺	zh-CN
chuanshuoge	传说哥	zh-CN
chuansong	传送	zh-CN
chuanzhang	船长	zh-CN
cichang	磁场	zh-CN
cuiduzhizhu	淬毒之珠	zh-CN
cuixisi	崔希丝	zh-CN
dadizhiling	大地之灵	zh-CN
dadianchui	大电锤	zh-CN
dadun	打盾	zh-CN
dagongzhishenli	达贡之神力	zh-CN
dajian	大剑	zh-CN
daleichui	大雷锤	zh-CN
damodaoshi	大魔导师	zh-CN
danajia	大娜迦	zh-CN
daniu	大牛	zh-CN
dapao	大炮	zh-CN
dashu	大树	zh-CN
datuan	打团	zh-CN
dayao	大药	zh-CN
daye	打野	zh-CN
dayu	大鱼	zh-CN
dayuren	大鱼人	zh-CN
dazirandeyanhu	大自然的掩护	zh-CN
daidaluosizhishang	代达罗斯之殇	zh-CN
daifen	带粉	zh-CN
daiweian	戴维安	zh-CN
daize	戴泽	zh-CN
danchewushi	单车武士	zh-CN
danmuchongji	弹幕冲击	zh-CN
daopian	刀片	zh-CN
daoying	倒影	zh-CN
deluyi	德鲁伊	zh-CN
denglizichang	等离子场	zh-CN
dibao	地堡	zh-CN
dibu	地卜	zh-CN
dibushi	地卜师	zh-CN
dicizhiwo	地磁之握	zh-CN
difashi	敌法师	zh-CN
dijingdetanlan	地精的贪婪	zh-CN
dijinggongchengshi	地精工程师	zh-CN
dijingsiliezhe	地精撕裂者	zh-CN
dijingxiubujiang	地精修补匠	zh-CN
dixuechongqun	地穴虫群	zh-CN
diyulieren	地狱烈刃	zh-CN
diyulingzhu	地狱领主	zh-CN
dizhen	地震	zh-CN
dizhishufu	地之束缚	zh-CN
dizhituxi	地之突袭	zh-CN
dizi	笛子	zh-CN
dizuizhiyan	涤罪之焰	zh-CN
diancimaichong	电磁脉冲	zh-CN
diangun	电棍	zh-CN
dianliu	电流	zh-CN
dianziwoliu	电子涡流	zh-CN
donglixie	动力鞋	zh-CN
dongnenglichang	动能立场	zh-CN
dongwuxinshi	动物信使	zh-CN
duci	毒刺	zh-CN
dugou	毒狗	zh-CN
dulong	毒龙	zh-CN
duqiu	毒球	zh-CN
duxinggongji	毒性攻击	zh-CN
duangun	短棍	zh-CN
duiye	堆野	zh-CN
duochongshifa	多重施法	zh-CN
emeng	噩梦	zh-CN
emengzhongzhi	噩梦终止	zh-CN
emodaofeng	恶魔刀锋	zh-CN
emosheling	恶魔赦令	zh-CN
emowushi	恶魔巫师	zh-CN
emozhuanhua	恶魔转化	zh-CN
enianpieshi	恶念瞥视	zh-CN
encijietuo	恩赐解脱	zh-CN
erta	二塔	zh-CN
faliliushi	法力流失	zh-CN
faliranshao	法力燃烧	zh-CN
falisunhui	法力损毁	zh-CN
falixiqu	法力吸取	zh-CN
falixukong	法力虚空	zh-CN
famuji	伐木机	zh-CN
famujulian	伐木锯链	zh-CN
fashegouzhao	发射钩爪	zh-CN
fashichangpao	法师长袍	zh-CN
fashuhudun	法术护盾	zh-CN
fatiao	发条	zh-CN
fatiaodijing	发条地精	zh-CN
fatiaojishi	发条技师	zh-CN
faya	发芽	zh-CN
fanbu	反补	zh-CN
fanji	反击	zh-CN
fanjiluoxuan	反击螺旋	zh-CN
feiji	飞机	zh-CN
feixingxinshi	飞行信使	zh-CN
feixuezhimao	沸血之矛	zh-CN
fenliejian	分裂箭	zh-CN
fenshenfu	分身斧	zh-CN
fenzenengcheng	分则能成	zh-CN
fenzhengmiansha	纷争面纱	zh-CN
fengbaoshuangxiong	风暴双雄	zh-CN
fengbaozhichui	风暴之锤	zh-CN
fengbaozhiling	风暴之灵	zh-CN
fengbaozhiquan	风暴之拳	zh-CN
fengbaozhiyan	风暴之眼	zh-CN
fenghuang	凤凰	zh-CN
fenghuangchongji	凤凰冲击	zh-CN
fengkuangmianju	疯狂面具	zh-CN
fengkuangshengzhang	疯狂生长	zh-CN
fengxing	风行	zh-CN
fengxingzhe	风行者	zh-CN
fengzhang	风杖	zh-CN
fuchou	复仇	zh-CN
fuchouguanghuan	复仇光环	zh-CN
fuchouzhihun	复仇之魂	zh-CN
fuhuazhizhu	孵化蜘蛛	zh-CN
fulan	腐烂	zh-CN
furouduiji	腐肉堆积	zh-CN
fushe	蝮蛇	zh-CN
fushetuxi	蝮蛇突袭	zh-CN
fushidu	腐尸毒	zh-CN
fushipifu	腐蚀皮肤	zh-CN
futou	斧头	zh-CN
fuwang	斧王	zh-CN
fuxiu	腐朽	zh-CN
fuzhi	复制	zh-CN
fuzhizhiqiang	复制之墙	zh-CN
fuzi	斧子	zh-CN
ganran	感染	zh-CN
ganraozhe	干扰者	zh-CN
gangbei	钢背	zh-CN
gangbeishou	钢背兽	zh-CN
gangbeizhu	钢背猪	zh-CN
gangduo	刚铎	zh-CN
gangmaohoubei	刚毛后背	zh-CN
gangshaoshouwei	岗哨守卫	zh-CN
gaodita	高地塔	zh-CN
gaoshehuopao	高射火炮	zh-CN
gekongquwu	隔空取物	zh-CN
gekongquwuzhuolu	隔空取物着陆	zh-CN
gelie	割裂	zh-CN
gongchengshi	工程师	zh-CN
gongjili	攻击力	zh-CN
gongjisudu	攻击速度	zh-CN
gongjizhizhao	攻击之爪	zh-CN
gongsu	攻速	zh-CN
gouhe	沟壑	zh-CN
gufa	骨法	zh-CN
gugong	骨弓	zh-CN
guhui	骨灰	zh-CN
guyinbu	骨隐步	zh-CN
guangfa	光法	zh-CN
guangjizhen	光击阵	zh-CN
guanglu	光鹿	zh-CN
guangzhishouwei	光之守卫	zh-CN
guijizhiwu	诡计之雾	zh-CN
guiyingchongchong	鬼影重重	zh-CN
guizuyuanhuan	贵族圆环	zh-CN
guozai	过载	zh-CN
hasika	哈斯卡	zh-CN
haijunshangjiang	海军上将	zh-CN
haixianghuiji	海象挥击	zh-CN
haixiangshenquan	海象神拳	zh-CN
haiyaowaike	海妖外壳	zh-CN
haiyaozhige	海妖之歌	zh-CN
hanbingsuipian	寒冰碎片	zh-CN
hanbingzhiqiang	寒冰之墙	zh-CN
handishenniu	撼地神牛	zh-CN
handizhe	撼地者	zh-CN
handongfeilong	寒冬飞龙	zh-CN
handongzuzhou	寒冬诅咒	zh-CN
hanshuangbaofa	寒霜暴发	zh-CN
hanshuangzhizu	寒霜之足	zh-CN
hantiegangzhao	寒铁钢爪	zh-CN
haojiao	嗥叫	zh-CN
heianqiyue	黑暗契约	zh-CN
heianshijian	黑暗时间	zh-CN
heianxianzhe	黑暗贤者	zh-CN
heianzhimen	黑暗之门	zh-CN
heidong	黑洞	zh-CN
heihuangzhang	黑皇杖	zh-CN
heiniao	黑鸟	zh-CN
heixian	黑贤	zh-CN
honglian	红莲	zh-CN
hongliu	洪流	zh-CN
hongzhang	红杖	zh-CN
houzi	猴子	zh-CN
hudie	蝴蝶	zh-CN
huguangshouwangzhe	弧光守望者	zh-CN
hujia	护甲	zh-CN
huniu	虎妞	zh-CN
huwan	护腕	zh-CN
huxingshandian	弧形闪电	zh-CN
huyou	忽悠	zh-CN
huaxuekuangbao	化学狂暴	zh-CN
huanci	幻刺	zh-CN
huanxiang	幻象	zh-CN
huanxiangfaqiu	幻象法球	zh-CN
huanxiangfu	幻象符	zh-CN
huanxiangshenfu	幻象神符	zh-CN
huanxinzhiren	欢欣之刃	zh-CN
huanyingchangmaoshou	幻影长矛手	zh-CN
huanyingchongfeng	幻影冲锋	zh-CN
huanyingcike	幻影刺客	zh-CN
huanyingfu	幻影斧	zh-CN
huanyingtuxi	幻影突袭	zh-CN
huangchong	蝗虫	zh-CN
huangquanchandou	黄泉颤抖	zh-CN
huangwu	荒芜	zh-CN
huichengjuanzhou	回城卷轴	zh-CN
huidaoguoqu	回到过去	zh-CN
huifu	回复	zh-CN
huifufu	回复符	zh-CN
huifujiezhi	回复戒指	zh-CN
huifushenfu	回复神符	zh-CN
huifutoujin	恢复头巾	zh-CN
huiguangfanzhao	回光返照	zh-CN
huijinzhiling	灰烬之灵	zh-CN
huimie	毁灭	zh-CN
huimieyinying	毁灭阴影	zh-CN
huiniao	灰鸟	zh-CN
huiyao	辉耀	zh-CN
huiyinji	回音击	zh-CN
huiyinzhongta	回音重踏	zh-CN
hundun	混沌	zh-CN
hundunqishi	混沌骑士	zh-CN
hundunyiji	混沌一击	zh-CN
hundunyunshi	混沌陨石	zh-CN
hunluanzhiji	混乱之祭	zh-CN
hunluanzhijian	混乱之箭	zh-CN
hunshou	魂守	zh-CN
hunyuan	混源	zh-CN
hunzhiwange	魂之挽歌	zh-CN
huojian	火箭	zh-CN
huojiandanmu	火箭弹幕	zh-CN
huoliqiu	活力球	zh-CN
huolizhiqiu	活力之球	zh-CN
huoluan	祸乱	zh-CN
huoluanzhiyuan	祸乱之源	zh-CN
huomao	火猫	zh-CN
huonv	火女	zh-CN
huoqiang	火枪	zh-CN
huotihujia	活体护甲	zh-CN
huoxinghujia	活性护甲	zh-CN
huoxiongmao	火熊猫	zh-CN
huoxueshu	活血术	zh-CN
huoyanbaohong	火焰爆轰	zh-CN
huoyanfeixing	火焰飞行	zh-CN
huoyanfengbao	火焰风暴	zh-CN
huoyanqixi	火焰气息	zh-CN
jidujike	极度饥渴	zh-CN
jiguang	激光	zh-CN
jihanlingyu	极寒领域	zh-CN
jihanyouhun	极寒幽魂	zh-CN
jihanzhichu	极寒之触	zh-CN
jihanzhiyong	极寒之拥	zh-CN
jihuocanyan	激活残焰	zh-CN
jiliu	激流	zh-CN
jinengqiequ	技能窃取	zh-CN
jinu	激怒	zh-CN
jipin	祭品	zh-CN
jiqirendejinjun	机器人的进军	zh-CN
jishengzhongzi	寄生种子	zh-CN
jisu	极速	zh-CN
jisufu	极速符	zh-CN
jisulengque	急速冷却	zh-CN
jisushenfu	极速神符	zh-CN
jixianfaqiu	极限法球	zh-CN
jizhonghuoli	集中火力	zh-CN
jizhongyinbao	集中引爆	zh-CN
jiasushoutao	加速手套	zh-CN
jiasuo	枷锁	zh-CN
jiatui	假腿	zh-CN
jiayan	假眼	zh-CN
jianciwaike	尖刺外壳	zh-CN
jianrenfengbao	剑刃风暴	zh-CN
jianrenqiu	坚韧球	zh-CN
jiansheng	剑圣	zh-CN
jianwu	剑舞	zh-CN
jianglin	降临	zh-CN
jiangshi	僵尸	zh-CN
jiaotu	焦土	zh-CN
jieqiluo	杰奇洛	zh-CN
jiexinguanghuan	竭心光环	zh-CN
jingubang	金箍棒	zh-CN
jinzhan	近战	zh-CN
jinzhanbingying	近战兵营	zh-CN
jingdianchang	静电场	zh-CN
jingdianlianjie	静电连接	zh-CN
jinghuayaoshui	净化药水	zh-CN
jinghunzhiren	惊魂之刃	zh-CN
jinglingbudai	精灵布带	zh-CN
jinglinglong	精灵龙	zh-CN
jinglingshouwei	精灵守卫	zh-CN
jingmizhixie	静谧之鞋	zh-CN
jingmozuzhou	静默诅咒	zh-CN
jingqiguanghuan	精气光环	zh-CN
jingqiqiu	精气球	zh-CN
jingqizhiqiu	精气之球	zh-CN
jingtaifengbao	静态风暴	zh-CN
jingxiang	镜像	zh-CN
jiuxian	酒仙	zh-CN
jubian	巨变	zh-CN
juchifeilun	锯齿飞轮	zh-CN
judu	剧毒	zh-CN
judushushi	剧毒术士	zh-CN
juduxinxing	剧毒新星	zh-CN
juduzhichu	剧毒之触	zh-CN
jujishou	狙击手	zh-CN
julang	巨浪	zh-CN
julihuiwu	巨力挥舞	zh-CN
julizhongji	巨力重击	zh-CN
jumo	巨魔	zh-CN
jumozhanjiang	巨魔战将	zh-CN
jushichongji	巨石冲击	zh-CN
jushifangun	巨石翻滚	zh-CN
juya	巨牙	zh-CN
juyahaimin	巨牙海民	zh-CN
juedichuanci	掘地穿刺	zh-CN
juedou	决斗	zh-CN
jueshamiji	绝杀秘技	zh-CN
juntuan	军团	zh-CN
juntuanzhihuiguan	军团指挥官	zh-CN
kaer	卡尔	zh-CN
kaluoke	卡洛克	zh-CN
kaiwu	开雾	zh-CN
kaolin	考林	zh-CN
kelinkezi	克林克兹	zh-CN
kongaozhixin	恐鳌之心	zh-CN
kongbubodong	恐怖波动	zh-CN
kongbuliren	恐怖利刃	zh-CN
konglingguajian	空灵挂件	zh-CN
kongmingzhang	空明杖	zh-CN
kulougongjianshou	骷髅弓箭手	zh-CN
kulouwang	骷髅王	zh-CN
kuangbao	狂暴	zh-CN
kuangfeng	狂风	zh-CN
kuangmeng	狂猛	zh-CN
kuangzhanfu	狂战斧	zh-CN
kuangzhanshidenuhou	狂战士的怒吼	zh-CN
kuangzhanshizhinu	狂战士之怒	zh-CN
kuangzhanshizhixue	狂战士之血	zh-CN
kunka	昆卡	zh-CN
kuojian	阔剑	zh-CN
labike	拉比克	zh-CN
ladeng	拉登	zh-CN
lashuangye	拉双野	zh-CN
laxike	拉席克	zh-CN
lazeerheiniang	拉泽尔黑酿	zh-CN
laien	莱恩	zh-CN
lanliang	蓝量	zh-CN
lanmao	蓝猫	zh-CN
lanpang	蓝胖	zh-CN
lanpangzi	蓝胖子	zh-CN
lanping	蓝瓶	zh-CN
langren	狼人	zh-CN
laolu	老鹿	zh-CN
leigeshiti	雷格石蹄	zh-CN
leiji	雷击	zh-CN
leiqubiaozhi	雷区标识	zh-CN
leishenzhichui	雷神之锤	zh-CN
leishenzhinu	雷神之怒	zh-CN
leitingyiji	雷霆一击	zh-CN
leitingzhiji	雷霆之击	zh-CN
ligewo	黎格沃	zh-CN
liliang	力量	zh-CN
liliangshoutao	力量手套	zh-CN
liliangyaodai	力量腰带	zh-CN
lina	莉娜	zh-CN
liwan	力丸	zh-CN
liweitan	利维坦	zh-CN
liziwaike	离子外壳	zh-CN
lianhuanshuangdong	连环霜冻	zh-CN
lianji	连击	zh-CN
lianjin	炼金	zh-CN
lianjinshushi	练金术士	zh-CN
liangjifanzhuan	两级反转	zh-CN
liaoyachongci	獠牙冲刺	zh-CN
liedigouhe	裂地沟壑	zh-CN
liedijianci	裂地尖刺	zh-CN
liehunren	裂魂人	zh-CN
liehuozhao	烈火罩	zh-CN
liehuozhikao	烈火炙烤	zh-CN
lieshilu	劣势路	zh-CN
lieyanfenshen	烈焰焚身	zh-CN
lieyanjingling	烈焰精灵	zh-CN
lieyanpoji	烈焰破击	zh-CN
lingdongxunjie	灵动迅捷	zh-CN
lingdongzhiyi	灵动之翼	zh-CN
linghunchaodu	灵魂超度	zh-CN
linghungeduan	灵魂隔断	zh-CN
linghunlieshou	灵魂猎手	zh-CN
linghunshouwei	灵魂守卫	zh-CN
linghunxingtai	灵魂形态	zh-CN
linghunzhijie	灵魂之戒	zh-CN
linghunzhimao	灵魂之矛	zh-CN
linglongxin	玲珑心	zh-CN
lingnengxianjing	灵能陷阱	zh-CN
lingnengzhiren	灵能之刃	zh-CN
lingweidoupeng	陵卫斗篷	zh-CN
liulang	流浪	zh-CN
liulangjianke	流浪剑客	zh-CN
liuxiandan	榴霰弹	zh-CN
liuxing	流星	zh-CN
longpozhan	龙破斩	zh-CN
longqi	龙骑	zh-CN
longqishi	龙骑士	zh-CN
longying	龙鹰	zh-CN
longzuxuetong	龙族血统	zh-CN
lufutelun	鲁夫特仑	zh-CN
luna	露娜	zh-CN
luxifa	路西法	zh-CN
luanliu	乱流	zh-CN
lueduozhezhifu	掠夺者之斧	zh-CN
lvxie	绿鞋	zh-CN
lvzhang	绿杖	zh-CN
mabixianjing	麻痹陷阱	zh-CN
mabiyaoji	麻痹药剂	zh-CN
mabizhiyao	麻痹之咬	zh-CN
magenasi	马格纳斯	zh-CN
majina	玛吉纳	zh-CN
matijianta	马蹄践踏	zh-CN
maibudilei	埋布地雷	zh-CN
maichongxinxing	脉冲新星	zh-CN
maidasizhishou	迈达斯之手	zh-CN
manjikesi	曼吉克斯	zh-CN
maoji	锚击	zh-CN
meidusha	美杜莎	zh-CN
meihuo	魅惑	zh-CN
meihuomonv	魅惑魔女	zh-CN
meikensimu	梅肯斯姆	zh-CN
meikensimudongchayandou	梅肯斯姆洞察烟斗	zh-CN
menggekehan	蒙哥可汗	zh-CN
mengjingchanrao	梦境缠绕	zh-CN
mibo	米波	zh-CN
mifajian	秘法箭	zh-CN
mifaxie	秘法鞋	zh-CN
milana	米拉娜	zh-CN
mishuyishe	秘术异蛇	zh-CN
mituan	谜团	zh-CN
miyinchui	秘银锤	zh-CN
miaozhun	瞄准	zh-CN
minjie	敏捷	zh-CN
minjiebianxue	敏捷便靴	zh-CN
minghundadi	冥魂大帝	zh-CN
minghuobaoji	冥火爆击	zh-CN
mingjieyalong	冥界亚龙	zh-CN
mingyunchiling	命运敕令	zh-CN
mobang	魔棒	zh-CN
mofahudun	魔法护盾	zh-CN
mofajian	魔法箭	zh-CN
mofajingxiang	魔法镜像	zh-CN
mofamangguo	魔法芒果	zh-CN
mohu	模糊	zh-CN
mojingshenshizhe	殁境神蚀者	zh-CN
mokang	魔抗	zh-CN
mokangdoupeng	魔抗斗篷	zh-CN
molifazhang	魔力法杖	zh-CN
molongqiang	魔龙枪	zh-CN
moping	魔瓶	zh-CN
moqiuli	墨丘利	zh-CN
mori	末日	zh-CN
moribaba	末日爸爸	zh-CN
morishizhe	末日使者	zh-CN
mowangjianglin	魔王降临	zh-CN
mozhang	魔杖	zh-CN
mozhao	魔爪	zh-CN
mubei	墓碑	zh-CN
najiahaiyao	娜迦海妖	zh-CN
naikesi	奈克斯	zh-CN
nailao	奶酪	zh-CN
naisaji	耐萨基	zh-CN
naiwenmoer	奈文摩尔	zh-CN
nengliangchilun	能量齿轮	zh-CN
nengliangqiu	能量球	zh-CN
nengliangzhiqiu	能量之球	zh-CN
nengliangzhuanyi	能量转移	zh-CN
nianchoubiti	粘稠鼻涕	zh-CN
nianxingranyou	粘性燃油	zh-CN
niutourenqiuzhang	牛头人酋长	zh-CN
nuyikuangji	怒意狂击	zh-CN
nuochong	诺崇	zh-CN
pagena	帕格纳	zh-CN
paji	帕吉	zh-CN
pake	帕克	zh-CN
paipai	拍拍	zh-CN
paipaixiong	拍拍熊	zh-CN
pulisiteleiting	普利斯特雷霆	zh-CN
qiqiuzhe	祈求者	zh-CN
qiquwaibiao	崎岖外表	zh-CN
qiyunzhimo	气运之末	zh-CN
qianggong	强攻	zh-CN
qianghuatuteng	强化图腾	zh-CN
qiangjiguanghuan	强击光环	zh-CN
qiangliji	强力击	zh-CN
qiangxi	强袭	zh-CN
qiangxijufeng	强袭飓风	zh-CN
qiangxixiongjia	强袭胸甲	zh-CN
qinglianbaozhu	清莲宝珠	zh-CN
qiongguidun	穷鬼盾	zh-CN
qiuzhuangshandian	球状闪电	zh-CN
qushieling	驱使恶灵	zh-CN
quzhu	驱逐	zh-CN
quanlingyuchenmo	全领域沉默	zh-CN
quanneng	全能	zh-CN
quannengqishi	全能骑士	zh-CN
qunsheshouwei	群蛇守卫	zh-CN
qunxingfengbao	群星风暴	zh-CN
qunxingyunluo	群星陨落	zh-CN
ranshaojiasuo	燃烧枷锁	zh-CN
redaofeidan	热导飞弹	zh-CN
rexuezhanhun	热血战魂	zh-CN
rengu	韧鼓	zh-CN
renjia	刃甲	zh-CN
renma	人马	zh-CN
renshu	忍术	zh-CN
renxingtai	人形态	zh-CN
ronglujingling	熔炉精灵	zh-CN
rougou	肉钩	zh-CN
roushandun	肉山盾	zh-CN
ruituocuipu	瑞托崔普	zh-CN
ruizilake	瑞兹拉克	zh-CN
ruohuanengliu	弱化能流	zh-CN
sadanzhixieli	撒旦之邪力	zh-CN
saer	萨尔	zh-CN
safen	撒粉	zh-CN
sanhua	散华	zh-CN
sanshi	散失	zh-CN
sanyeduijian	散夜对剑	zh-CN
saoshe	扫射	zh-CN
shachenbao	沙尘暴	zh-CN
shawang	沙王	zh-CN
shanbeng	山崩	zh-CN
shanbihufu	闪避护符	zh-CN
shandianfengbao	闪电风暴	zh-CN
shandianyouhun	闪电幽魂	zh-CN
shandianzhilian	闪电之链	zh-CN
shanguangyouhun	闪光幽魂	zh-CN
shanling	山岭	zh-CN
shanlingjuren	山岭巨人	zh-CN
shanshuo	闪烁	zh-CN
shanshuobishou	闪烁匕首	zh-CN
shanshuotuxi	闪烁突袭	zh-CN
shangcankongju	伤残恐惧	zh-CN
shangdizhishou	上帝之手	zh-CN
shangerta	上二塔	zh-CN
shanggaodita	上高地塔	zh-CN
shanggufengyin	上古封印	zh-CN
shanggujushen	上古巨神	zh-CN
shanghai	伤害	zh-CN
shangjin	赏金	zh-CN
shangjinfu	赏金符	zh-CN
shangjinlieren	赏金猎人	zh-CN
shangjinshenfu	赏金神符	zh-CN
shanglu	上路	zh-CN
shangwaita	上外塔	zh-CN
shebang	蛇棒	zh-CN
shefanvyao	蛇发女妖	zh-CN
sheshoutianfu	射手天赋	zh-CN
shenjian	神箭	zh-CN
shenlingwushi	神灵武士	zh-CN
shenlongbaiwei	神龙摆尾	zh-CN
shenmifazhang	神秘法杖	zh-CN
shenmizhiyao	神秘之耀	zh-CN
shenmiezhan	神灭斩	zh-CN
shenniu	神牛	zh-CN
shenshengfazhang	神圣法杖	zh-CN
shenshengquanhua	神圣劝化	zh-CN
shenwang	神王	zh-CN
shenxingbaibian	神行百变	zh-CN
shenxingtaibao	神行太保	zh-CN
shenyuzhe	神谕者	zh-CN
shenyuanlingzhu	深渊领主	zh-CN
shenyuanzhiren	深渊之刃	zh-CN
shenzhililiang	神之力量	zh-CN
shenzhizhishi	神智之蚀	zh-CN
shengdian	圣殿	zh-CN
shengdianzhihuan	圣殿指环	zh-CN
shengjian	圣剑	zh-CN
shengmingjiqu	生命汲取	zh-CN
shengqishi	圣骑士	zh-CN
shengtang	圣堂	zh-CN
shengtangcike	圣堂刺客	zh-CN
shengyan	盛宴	zh-CN
shengzheyiwu	圣者遗物	zh-CN
shideliguer	史德利古尔	zh-CN
shifanganyingdu	释放暗影毒	zh-CN
shifangchongjibo	释放冲击波	zh-CN
shiguangdaoliu	时光倒流	zh-CN
shihuaningshi	石化凝视	zh-CN
shihun	噬魂	zh-CN
shihungui	噬魂鬼	zh-CN
shijianjiejie	时间结界	zh-CN
shijianmanyou	时间漫游	zh-CN
shijianpengzhang	时间膨胀	zh-CN
shijiansuoding	时间锁定	zh-CN
shinao	蚀脑	zh-CN
shinuezhixin	施虐之心	zh-CN
shirenmomofashi	食人魔魔法师	zh-CN
shirenmozhifu	食人魔之斧	zh-CN
shishigui	食尸鬼	zh-CN
shiwang	尸王	zh-CN
shixianggui	石像鬼	zh-CN
shixiangliexi	实相裂隙	zh-CN
shixiaolichang	失效立场	zh-CN
shixuekewang	嗜血渴望	zh-CN
shixuekuangmo	嗜血狂魔	zh-CN
shixueshu	嗜血术	zh-CN
shougaodi	守高地	zh-CN
shouhutianshi	守护天使	zh-CN
shouhuzhihuan	守护指环	zh-CN
shouta	守塔	zh-CN
shouwang	兽王	zh-CN
shouweijianglin	守卫降临	zh-CN
shouyuliliang	授予力量	zh-CN
shouzhemodelinghun	受折磨的灵魂	zh-CN
shufuji	束缚击	zh-CN
shujingweishi	树精卫士	zh-CN
shuren	树人	zh-CN
shushi	术士	zh-CN
shusiyibo	殊死一搏	zh-CN
shuxingfujia	属性附加	zh-CN
shuzhi	树枝	zh-CN
shuzhijisi	树之祭祀	zh-CN
shuzui	赎罪	zh-CN
shuaxinqiu	刷新球	zh-CN
shuailao	衰老	zh-CN
shuaituiguanghuan	衰退光环	zh-CN
shuangbei	双倍	zh-CN
shuangbeifu	双倍符	zh-CN
shuangbeishenfu	双倍神符	zh-CN
shuangdao	双刀	zh-CN
shuangdonghujia	霜冻护甲	zh-CN
shuangdongzhijian	霜冻之箭	zh-CN
shuangrenjian	双刃剑	zh-CN
shuangtoulong	双头龙	zh-CN
shuangzhiaishang	霜之哀伤	zh-CN
shuidao	水刀	zh-CN
shuijingjian	水晶剑	zh-CN
shuijingshinv	水晶室女	zh-CN
shuiren	水人	zh-CN
sijiadizhiyan	斯嘉蒂之眼	zh-CN
silada	斯拉达	zh-CN
silake	斯拉克	zh-CN
siliedadi	撕裂大地	zh-CN
silieshangkou	撕裂伤口	zh-CN
silingfa	死灵法	zh-CN
silingfeilong	死灵飞龙	zh-CN
silingshu	死灵书	zh-CN
sishenliandao	死神镰刀	zh-CN
siwang	死亡	zh-CN
siwangchanrao	死亡缠绕	zh-CN
siwangmaichong	死亡脉冲	zh-CN
siwangqiyue	死亡契约	zh-CN
siwangshouwei	死亡守卫	zh-CN
siwangxianzhi	死亡先知	zh-CN
siwangxuanfeng	死亡旋风	zh-CN
siwangzhizhi	死亡之指	zh-CN
siwen	斯温	zh-CN
siyecike	司夜刺客	zh-CN
suduzhixue	速度之靴	zh-CN
suanwu	酸雾	zh-CN
suanxingpenwu	酸性喷雾	zh-CN
suiguchui	碎骨锤	zh-CN
suiliechongji	碎裂冲击	zh-CN
suiluchui	碎颅锤	zh-CN
suodi	缩地	zh-CN
suozijia	锁子甲	zh-CN
taotaizhiren	淘汰之刃	zh-CN
tesiding	特斯丁	zh-CN
tidao	剃刀	zh-CN
tihuanfuzhipin	替换复制品	zh-CN
tianhui	天辉	zh-CN
tiannufashi	天怒法师	zh-CN
tianqiongshouwangzhe	天穹守望者	zh-CN
tiantangzhiji	天堂之戟	zh-CN
tianying	天鹰	zh-CN
tianyingjie	天鹰戒	zh-CN
tianyingzhijie	天鹰之戒	zh-CN
tiaodao	跳刀	zh-CN
tiaoyue	跳跃	zh-CN
tiaozhantoujin	挑战头巾	zh-CN
tieshuzhigan	铁树枝干	zh-CN
tieyitoukui	铁意头盔	zh-CN
tongkujianjiao	痛苦尖叫	zh-CN
tongkunvwang	痛苦女王	zh-CN
tongkuzhiyuan	痛苦之源	zh-CN
touzhi	投掷	zh-CN
touzhifeibiao	投掷飞镖	zh-CN
tufu	屠夫	zh-CN
tumao	土猫	zh-CN
tuxi	突袭	zh-CN
tuzi	兔子	zh-CN
tuihuaguanghuan	退化光环	zh-CN
tuijin	推进	zh-CN
tuitui	推推	zh-CN
tuituibang	推推棒	zh-CN
tunshi	吞噬	zh-CN
waita	外塔	zh-CN
wangzhezhijie	王者之戒	zh-CN
weiguangpifeng	微光披风	zh-CN
weijingtongdehuoyanbaohong	未精通的火焰爆轰	zh-CN
weisaji	维萨吉	zh-CN
weishijingjia	卫士胫甲	zh-CN
wenyifashi	瘟疫法师	zh-CN
wenyishouwei	瘟疫守卫	zh-CN
wudizhan	无敌斩	zh-CN
wuduhuifushu	巫毒回复术	zh-CN
wuguangzhidun	无光之盾	zh-CN
wushu	巫术	zh-CN
wushujingyan	巫术精研	zh-CN
wuyao	巫妖	zh-CN
wuyediaoling	午夜凋零	zh-CN
wuyi	巫医	zh-CN
wuyingquan	无影拳	zh-CN
xihunwushu	吸魂巫术	zh-CN
xili	洗礼	zh-CN
xisheng	牺牲	zh-CN
xiwa	希瓦	zh-CN
xiwadeshouhu	希瓦的守护	zh-CN
xixueguanghuan	吸血光环	zh-CN
xixuemianju	吸血面具	zh-CN
xiaerta	下二塔	zh-CN
xiagaodita	下高地塔	zh-CN
xialu	下路	zh-CN
xiawaita	下外塔	zh-CN
xianfengdun	先锋盾	zh-CN
xianlingzhihuo	仙灵之火	zh-CN
xiannvlong	仙女龙	zh-CN
xianyingzhichen	显影之尘	zh-CN
xianzhemianzhao	贤者面罩	zh-CN
xianzhi	先知	zh-CN
xianzuzhihun	先祖之魂	zh-CN
xiangwei	相位	zh-CN
xiangweixie	相位鞋	zh-CN
xiangweizhuanyi	相位转移	zh-CN
xiaodianchui	小电锤	zh-CN
xiaohei	小黑	zh-CN
xiaohuoren	小火人	zh-CN
xiaojingling	小精灵	zh-CN
xiaokulou	小骷髅	zh-CN
xiaoleichui	小雷锤	zh-CN
xiaolu	小鹿	zh-CN
xiaomituan	小谜团	zh-CN
xiaonajia	小娜迦	zh-CN
xiaoniu	小牛	zh-CN
xiaoqiang	小强	zh-CN
xiaorenshu	小人书	zh-CN
xiaoshuren	小树人	zh-CN
xiaowai	小歪	zh-CN
xiaoxiao	小小	zh-CN
xiaoyu	小鱼	zh-CN
xiaoyuren	小鱼人	zh-CN
xieejinghua	邪恶净化	zh-CN
xieeliandao	邪恶镰刀	zh-CN
xietong	协同	zh-CN
xinyuezhihen	新月之痕	zh-CN
xingtijingu	星体禁锢	zh-CN
xiongde	熊德	zh-CN
xionglinghuoban	熊灵伙伴	zh-CN
xiongmaojiuxian	熊猫酒仙	zh-CN
xiongzhanshi	熊战士	zh-CN
xiubujiang	修补匠	zh-CN
xiudoumodaoshi	秀逗魔导士	zh-CN
xukong	虚空	zh-CN
xukongjiamian	虚空假面	zh-CN
xulingdao	虚灵刀	zh-CN
xulingzhiren	虚灵之刃	zh-CN
xuruo	虚弱	zh-CN
xuwangzhinuo	虚妄之诺	zh-CN
xuwubaoshi	虚无宝石	zh-CN
xuanfengfeifu	旋风飞斧	zh-CN
xuanmingdunpai	玄冥盾牌	zh-CN
xuanwo	漩涡	zh-CN
xuejing	血精	zh-CN
xuejingshi	血精石	zh-CN
xueliang	血量	zh-CN
xuemo	血魔	zh-CN
xueping	血瓶	zh-CN
xueqiu	雪球	zh-CN
xueroukuilei	血肉傀儡	zh-CN
xuezhijisi	血之祭祀	zh-CN
xuezhikuangbao	血之狂暴	zh-CN
yabadun	亚巴顿	zh-CN
yadaoxingyoushi	压倒性优势	zh-CN
yazhizhiren	压制之刃	zh-CN
yanhanshaozhuo	严寒烧灼	zh-CN
yanmiefashi	湮灭法师	zh-CN
yanmu	烟幕	zh-CN
yanyangsuo	炎阳索	zh-CN
yanyangwenzhang	炎阳纹章	zh-CN
yanyangzhiguan	炎阳之冠	zh-CN
yangdao	羊刀	zh-CN
yangyanchongji	阳炎冲击	zh-CN
yaokongzhadan	遥控炸弹	zh-CN
yaoshu	妖术	zh-CN
yaoyaole	摇摇乐	zh-CN
yecha	夜叉	zh-CN
yemanpaoxiao	野蛮咆哮	zh-CN
yemo	夜魔	zh-CN
yequ	野区	zh-CN
yetaihuo	液态火	zh-CN
yewanzhongdeshouliezhe	夜晚中的狩猎者	zh-CN
yexinghuhuan	野性呼唤	zh-CN
yexingqushi	野性驱使	zh-CN
yexingzhifu	野性之斧	zh-CN
yexingzhixin	野性之心	zh-CN
yeyan	夜魇	zh-CN
yidongsudu	移动速度	zh-CN
yijie	一姐	zh-CN
yikaluosi	伊卡洛斯	zh-CN
yisu	移速	zh-CN
yitaizhijing	以太之镜	zh-CN
yiwangfashi	遗忘法师	zh-CN
yixinghuanwei	移形换位	zh-CN
yinci	隐刺	zh-CN
yindao	隐刀	zh-CN
yinni	隐匿	zh-CN
yinran	引燃	zh-CN
yinshen	隐身	zh-CN
yinshenfu	隐身符	zh-CN
yinshenshenfu	隐身神符	zh-CN
yinxingcike	隐形刺客	zh-CN
yinyuezhijing	银月之晶	zh-CN
yinzangzhedezi	吟葬者德兹	zh-CN
yinggegong	鹰歌弓	zh-CN
yingjiaogong	鹰角弓	zh-CN
yingmo	影魔	zh-CN
yingren	影刃	zh-CN
yingzhilingkan	影之灵龛	zh-CN
yongjiuyinshen	永久隐身	zh-CN
yongqixunzhang	勇气勋章	zh-CN
yongqizhisha	勇气之霎	zh-CN
youbu	诱捕	zh-CN
youguangzhihun	幽光之魂	zh-CN
yougui	幽鬼	zh-CN
youguizhiren	幽鬼之刃	zh-CN
youhunquanzhang	幽魂权杖	zh-CN
youlingchuan	幽灵船	zh-CN
youlingmanbu	幽灵漫步	zh-CN
youmier	尤弥尔	zh-CN
youmingbaohong	幽冥爆轰	zh-CN
youmingjudu	幽冥剧毒	zh-CN
youmingshouwei	幽冥守卫	zh-CN
youmingyiji	幽冥一击	zh-CN
younieruo	尤涅若	zh-CN
youshilu	优势路	zh-CN
yumuzhizhu	育母蜘蛛	zh-CN
yurenshouwei	鱼人守卫	zh-CN
yurensuiji	鱼人碎击	zh-CN
yurenyexingzhe	鱼人夜行者	zh-CN
yuzhen	余震	zh-CN
yuancheng	远程	zh-CN
yuanchengbingying	远程兵营	zh-CN
yuandun	圆盾	zh-CN
yuangubinghun	远古冰魂	zh-CN
yuanhuan	圆环	zh-CN
yuanlifazhang	原力法杖	zh-CN
yuanlingjidai	怨灵系带	zh-CN
yuannianshenyuan	怨念深渊	zh-CN
yuanshipaoxiao	原始咆哮	zh-CN
yuansufenli	元素分离	zh-CN
yuanxingxie	远行鞋	zh-CN
yueguang	月光	zh-CN
yuenv	月女	zh-CN
yueqi	月骑	zh-CN
yueren	月刃	zh-CN
yueshenzhijian	月神之箭	zh-CN
yueshi	月蚀	zh-CN
yuezhianmian	月之暗面	zh-CN
yuezhigongzhu	月之公主	zh-CN
yuezhinvjisi	月之女祭司	zh-CN
yuezhiqishi	月之骑士	zh-CN
yuezhizhufu	月之祝福	zh-CN
zaizhuangtian	再装填	zh-CN
zete	泽特	zh-CN
zengwu	憎恶	zh-CN
zhadan	炸弹	zh-CN
zhadanren	炸弹人	zh-CN
zhagongnasi	扎贡纳斯	zh-CN
zhandouhaojiao	战斗嚎叫	zh-CN
zhandoujike	战斗饥渴	zh-CN
zhandouzhuanzhu	战斗专注	zh-CN
zhangu	战鼓	zh-CN
zhanhou	战吼	zh-CN
zhanyi	战意	zh-CN
zhangda	长大	zh-CN
zhangqi	瘴气	zh-CN
zhaohuan	召唤	zh-CN
zhaohuanfeidan	召唤飞弹	zh-CN
zhaohuanyongshou	召唤佣兽	zh-CN
zhaohui	召回	zh-CN
zhaolang	召狼	zh-CN
zhaominghuojian	照明火箭	zh-CN
zheguang	折光	zh-CN
zheshe	折射	zh-CN
zhenchashouwei	侦查守卫	zh-CN
zhencisaoshe	针刺扫射	zh-CN
zhendangbo	震荡波	zh-CN
zhendangguangdan	震荡光弹	zh-CN
zhenfenbaoshi	振奋宝石	zh-CN
zhenhandadi	震撼大地	zh-CN
zhenhunshi	镇魂石	zh-CN
zhenkong	真空	zh-CN
zhenlongxingtai	真龙形态	zh-CN
zhenshi	真视	zh-CN
zhenshibaoshi	真视宝石	zh-CN
zhenyan	真眼	zh-CN
zhengbu	正补	zh-CN
zhihuizhiren	智慧之刃	zh-CN
zhijie	肢解	zh-CN
zhili	智力	zh-CN
zhilidoupeng	智力斗篷	zh-CN
zhiliaoshouwei	治疗守卫	zh-CN
zhiliaoyaogao	治疗药膏	zh-CN
zhiliaozhihuan	治疗指环	zh-CN
zhimangzhiguang	致盲之光	zh-CN
zhiminglianjie	致命连接	zh-CN
zhimingyiji	致命一击	zh-CN
zhipeisiling	支配死灵	zh-CN
zhipeitoukui	支配头盔	zh-CN
zhiwang	织网	zh-CN
zhixizhiren	窒息之刃	zh-CN
zhongchengkaoyan	忠诚考验	zh-CN
zhongerta	中二塔	zh-CN
zhonggaodita	中高地塔	zh-CN
zhongji	重击	zh-CN
zhonglu	中路	zh-CN
zhongshenzhiwang	众神之王	zh-CN
zhongshu	种树	zh-CN
zhongwaita	中外塔	zh-CN
zhousi	宙斯	zh-CN
zhuzai	主宰	zh-CN
zhuaren	抓人	zh-CN
zhuizongdaodan	追踪导弹	zh-CN
zhuizongshu	追踪术	zh-CN
zhuoeryouxia	卓尔游侠	zh-CN
zhuorezhijian	灼热之箭	zh-CN
zirandehuhuan	自然的呼唤	zh-CN
ziranzhinu	自然之怒	zh-CN
ziranzhixu	自然秩序	zh-CN
ziranzhizhu	自然之助	zh-CN
zishagongji	自杀攻击	zh-CN
ziyuan	紫苑	zh-CN
zuzhou	诅咒	zh-CN
zuihouyiyan	最后遗言	zh-CN
zuijiuyunwu	醉酒云雾	zh-CN
zuiquan	醉拳	zh-CN
