# Gboard Dictionary version:1
along	阿隆	zh-CN
ashili	阿什利	zh-CN
aidehuakaer	爱德华卡尔	zh-CN
aikesiluode	艾克斯罗德	zh-CN
anquangongtongti	安全共同体	zh-CN
anquankunjing	安全困境	zh-CN
aoersen	奥尔森	zh-CN
baquanguojia	霸权国家	zh-CN
baquanwendinglilun	霸权稳定理论	zh-CN
baquanzhihou	霸权之后	zh-CN
baoshouzhuyi	保守主义	zh-CN
bentilun	本体论	zh-CN
bolatu	柏拉图	zh-CN
bopuer	波普尔	zh-CN
cengcifenxi	层次分析	zh-CN
chongtuboyijuzhen	冲突博弈矩阵	zh-CN
chuantongxianshizhuyi	传统现实主义	zh-CN
cipinshichang	次品市场	zh-CN
cuiruoxingxianghuyilai	脆弱性相互依赖	zh-CN
dabianche	搭便车	zh-CN
dajiaweiyirenyirenweidajia	大家为一人一人为大家	zh-CN
daixin	戴辛	zh-CN
daoyiwentijueduihua	道义问题绝对化	zh-CN
dierkaimu	迪尔凯姆	zh-CN
diguozhuyi	帝国主义	zh-CN
dikaer	笛卡尔	zh-CN
disanzhongyixiang	第三种意象	zh-CN
ertongrenzhishiyan	儿童认知实验	zh-CN
fanshepingjia	反射评价	zh-CN
fanshi	范式	zh-CN
fansizhuyi	反思主义	zh-CN
fangfalun	方法论	zh-CN
fenxicengci	分析层次	zh-CN
fuhaohudonglun	符号互动论	zh-CN
fuhexianghuyilai	复合相互依赖	zh-CN
gainianfenxi	概念分析	zh-CN
gainianguanximoxing	概念关系模型	zh-CN
gaojunsheng	高浚生	zh-CN
gaoshangtao	高尚涛	zh-CN
gaoshangtaoquanliyuguifan	高尚涛权力与规范	zh-CN
gelasaisifeierde	格拉塞斯菲尔德	zh-CN
gelike	格里科	zh-CN
getilixing	个体理性	zh-CN
getizhuyi	个体主义	zh-CN
getizhuyibentilun	个体主义本体论	zh-CN
getizhuyifangfalun	个体主义方法论	zh-CN
gonggongwupin	公共物品	zh-CN
gongshideshishi	共识的事实	zh-CN
gongtongzhishi	共同知识	zh-CN
gongyouzhishi	共有知识	zh-CN
guanlianfenxi	关联分析	zh-CN
guannianfenpeiji	观念分配及	zh-CN
guangyiguojiguanxi	广义国际关系	zh-CN
guifan	规范	zh-CN
guifanlilun	规范理论	zh-CN
guifanshiyongzhe	规范使用者	zh-CN
guifanyanjiufangfa	规范研究方法	zh-CN
guinawufa	归纳五法	zh-CN
guojifa	国际法	zh-CN
guojiguanxililunshidaolun	国际关系理论史导论	zh-CN
guojijiegou	国际结构	zh-CN
guojijingji	国际经济	zh-CN
guojiliyihexielun	国际利益和谐论	zh-CN
guojitixideguannianjiegou	国际体系的观念结构	zh-CN
guojitixiguifanjiegou	国际体系规范结构	zh-CN
guojitixijiegou	国际体系结构	zh-CN
guojixingguojia	国际性国家	zh-CN
guojizhengzhi	国际政治	zh-CN
guojizhengzhideshehuililun	国际政治的社会理论	zh-CN
guojizhengzhililun	国际政治理论	zh-CN
guojizhidudegongnenglilun	国际制度的功能理论	zh-CN
guojizuzhi	国际组织	zh-CN
guojizuzhijieshimoshi	国际组织解释模式	zh-CN
guojiadeshidongxingwenti	国家的施动性问题	zh-CN
guojiajianchongtu	国家间冲突	zh-CN
guojiajianzhengzhi	国家间政治	zh-CN
guojialiyi	国家利益	zh-CN
guojialiyidechongtu	国家利益的冲突	zh-CN
guojiashidongzhe	国家施动者	zh-CN
guojiaxingwei	国家行为	zh-CN
guojiaxingweiti	国家行为体	zh-CN
guojiazhongxinzhuyi	国家中心主义	zh-CN
hafoxuepai	哈佛学派	zh-CN
hexingainian	核心概念	zh-CN
hexinjiashe	核心假设	zh-CN
hengpuer	亨普尔	zh-CN
houxiandaililun	后现代理论	zh-CN
houxiandaizhuyi	后现代主义	zh-CN
hudongzhuyi	互动主义	zh-CN
huyingjizhi	互应机制	zh-CN
huyingluoji	互应逻辑	zh-CN
huobusiwuzhengfuwenhua	霍布斯无政府文化	zh-CN
huofuman	霍夫曼	zh-CN
jierping	吉尔平	zh-CN
jijinjiangouzhuyi	激进建构主义	zh-CN
jijinzhuyi	激进主义	zh-CN
jiouhan	基欧汉	zh-CN
jishulixing	技术理性	zh-CN
jitifeilixing	集体非理性	zh-CN
jitirentong	集体认同	zh-CN
jitishenfen	集体身份	zh-CN
jitishenfenxingcheng	集体身份形成	zh-CN
jitixingdongluoji	集体行动逻辑	zh-CN
jitizhishi	集体知识	zh-CN
jialifuniyazhoulidaxuebokelifenxiao	加利福尼亚州立大学伯克利分校	zh-CN
jiazhizhongli	价值中立	zh-CN
jiangouguanxi	建构关系	zh-CN
jiangouzhuyi	建构主义	zh-CN
jiegoubianhuadejiangouzhuyimoshi	结构变化的建构主义模式	zh-CN
jiegoujuedinglun	结构决定论	zh-CN
jiegoutiaojian	结构条件	zh-CN
jiegouxianshizhuyililun	结构现实主义理论	zh-CN
jiegouzhuyi	解构主义	zh-CN
jiegouzhuyi	结构主义	zh-CN
jinhuajizhi	进化机制	zh-CN
jingjibenneng	经济本能	zh-CN
jingjijinchengjieshimoshi	经济进程解释模式	zh-CN
jingyanrenshi	经验认识	zh-CN
jingyanshuju	经验数据	zh-CN
jueduishouyi	绝对收益	zh-CN
junshililun	均势理论	zh-CN
kangdewuzhengfuwenhua	康德无政府文化	zh-CN
kenucheng	克努成	zh-CN
keshizhengxing	可实证性	zh-CN
kesidingli	科斯定理	zh-CN
kexuebiaozhun	科学标准	zh-CN
kexuegemingdejiegou	科学革命的结构	zh-CN
kexuejiangouzhuyililun	科学建构主义理论	zh-CN
kexuerenyuquanlizhengzhi	科学人与权力政治	zh-CN
kexueshizailun	科学实在论	zh-CN
kexuexingweizhuyi	科学行为主义	zh-CN
kexueyanjiuganglingfangfalun	科学研究纲领方法论	zh-CN
kuen	库恩	zh-CN
lakatuosi	拉卡托斯	zh-CN
lilunjiashe	理论假设	zh-CN
linianzhuyi	理念主义	zh-CN
lixiangzhuyi	理想主义	zh-CN
lixing	理性	zh-CN
liangciyuedu	两次阅读	zh-CN
lujie	鲁杰	zh-CN
luoji	逻辑	zh-CN
luojishizhengzhuyi	逻辑实证主义	zh-CN
luokewuzhengfuwenhua	洛克无政府文化	zh-CN
mahe	马赫	zh-CN
mier	密尔	zh-CN
miersihaimo	米尔斯海默	zh-CN
minganxingxianghuyilai	敏感性相互依赖	zh-CN
minzhuhepinglun	民主和平论	zh-CN
mogensuo	摩根索	zh-CN
mubiaodelixingxingdong	目标的理性行动	zh-CN
neiwaihudongshi	内外互动式	zh-CN
nianweiji	年危机	zh-CN
nvxingzhuyi	女性主义	zh-CN
paleituociyoujie	帕累托次优解	zh-CN
paleituozuiyoujie	帕累托最优解	zh-CN
pengjiale	彭加勒	zh-CN
pipanlilun	批判理论	zh-CN
piyajie	皮亚杰	zh-CN
qimeier	齐美尔	zh-CN
qimengyundong	启蒙运动	zh-CN
qinshehuixingxingwei	亲社会性行为	zh-CN
qiutukunjing	囚徒困境	zh-CN
quanlidaodeguan	权力道德观	zh-CN
quanlifenpei	权力分配	zh-CN
quanlifenpeijiegou	权力分配结构	zh-CN
quanliguan	权力观	zh-CN
quanlijiedingdeguojialiyi	权力界定的国家利益	zh-CN
quanliyu	权力欲	zh-CN
quanliyuguifan	权力与规范	zh-CN
quanliyuxianghuyilai	权力与相互依赖	zh-CN
quanshixuepai	诠释学派	zh-CN
qunwoyishi	群我意识	zh-CN
renguojiayuzhanzheng	人国家与战争	zh-CN
renshilun	认识论	zh-CN
renxingdekeguanguilv	人性的客观规律	zh-CN
renxingxianshizhuyi	人性现实主义	zh-CN
renzhijiegou	认知结构	zh-CN
renzhipingheng	认知平衡	zh-CN
shehuihua	社会化	zh-CN
shehuijiangouzhuyi	社会建构主义	zh-CN
shehuijinchengdemoshi	社会进程的模式	zh-CN
shehuikexuefangfalun	社会科学方法论	zh-CN
shehuishishi	社会事实	zh-CN
shehuixide	社会习得	zh-CN
shehuiyanjiufangfa	社会研究方法	zh-CN
shengcunheyunxushengcun	生存和允许生存	zh-CN
shichangshilinglilun	市场失灵理论	zh-CN
shidongjiegou	施动结构	zh-CN
shidongzhehejiegoudehugou	施动者和结构的互构	zh-CN
shijiejingjitixi	世界经济体系	zh-CN
shijietixi	世界体系	zh-CN
shijiezhengzhi	世界政治	zh-CN
shijiezhengzhijiegou	世界政治结构	zh-CN
shisidianfangan	十四点方案	zh-CN
shizhengjianyan	实证检验	zh-CN
shizhengzhexuejiaocheng	实证哲学教程	zh-CN
shizhengzhuyideshiyonglingyu	实证主义的适用领域	zh-CN
shizhengzhuyifangfalun	实证主义方法论	zh-CN
shizhengzhuyirenshilun	实证主义认识论	zh-CN
shizhiguojia	实质国家	zh-CN
shouduanmudidelixing	手段目的的理性	zh-CN
shouyiyuqi	收益预期	zh-CN
shunying	顺应	zh-CN
sinaide	斯奈德	zh-CN
sugeladi	苏格拉底	zh-CN
suoyourenxiaomiesuoyourendezhanzhengzhuangtai	所有人消灭所有人的战争状态	zh-CN
tangpusen	汤普森	zh-CN
tixifenxi	体系分析	zh-CN
tixijiegou	体系结构	zh-CN
tixijincheng	体系进程	zh-CN
tixitezheng	体系特征	zh-CN
tiaojianhezuozhe	条件合作者	zh-CN
tonghua	同化	zh-CN
tushi	图式	zh-CN
wasikuizi	瓦斯奎兹	zh-CN
weibo	韦伯	zh-CN
weichixianzhuang	维持现状	zh-CN
weierxun	威尔逊	zh-CN
weierxunzhuyi	威尔逊主义	zh-CN
weike	维柯	zh-CN
weilieluxuepai	维列鲁学派	zh-CN
weisheguan	威慑观	zh-CN
weishelilun	威慑理论	zh-CN
weisitefaliyatiaoyue	维斯特伐利亚条约	zh-CN
weiwangzhengce	威望政策	zh-CN
weiyenaxuepai	维也纳学派	zh-CN
wenben	文本	zh-CN
wendingdejunhengjie	稳定的均衡解	zh-CN
wenhejiangouzhuyi	温和建构主义	zh-CN
wenhuaxuanze	文化选择	zh-CN
wente	温特	zh-CN
wentijiegoujieshimoshi	问题结构解释模式	zh-CN
woerzi	沃尔兹	zh-CN
woke	沃克	zh-CN
wolesitan	沃勒斯坦	zh-CN
wutuobangzhuyi	乌托邦主义	zh-CN
wuzhengfuwenhua	无政府文化	zh-CN
wuzhengfuzhuangtai	无政府状态	zh-CN
wuzhiyaosu	物质要素	zh-CN
xifangguojiguanxililun	西方国际关系理论	zh-CN
xitongshuju	系统数据	zh-CN
xiayiguojiguanxi	狭义国际关系	zh-CN
xiandaiguojiguanxi	现代国际关系	zh-CN
xiandaijiangouzhuyi	现代建构主义	zh-CN
xianshizhengzhi	现实政治	zh-CN
xianshizhuyiliuyuanze	现实主义六原则	zh-CN
xianyanzhuyi	先验主义	zh-CN
xiangduishouyi	相对收益	zh-CN
xinge	辛格	zh-CN
xingelanximakesizhuyi	新葛兰西马克思主义	zh-CN
xingudianjiangouzhuyi	新古典建构主义	zh-CN
xinxianshizhuyi	新现实主义	zh-CN
xinyang	信仰	zh-CN
xinziyouzhiduzhuyi	新自由制度主义	zh-CN
xinziyouzhuyi	新自由主义	zh-CN
xingershangxue	形而上学	zh-CN
yanjiugangling	研究纲领	zh-CN
yanjiushijiao	研究视角	zh-CN
yanjiuwenti	研究问题	zh-CN
yanzheng	验证	zh-CN
yibaohuanyibao	一报还一报	zh-CN
yituxing	意图性	zh-CN
yinguoguanxi	因果关系	zh-CN
yingguoxuepai	英国学派	zh-CN
yingranyanjiu	应然研究	zh-CN
yuedingshishi	约定事实	zh-CN
yuedingzhuyi	约定主义	zh-CN
zhanzhengyuheping	战争与和平	zh-CN
zhenglunzhongdeguojiguanxililun	争论中的国际关系理论	zh-CN
zhengtizhuyi	整体主义	zh-CN
zhengzhixianshizhuyi	政治现实主义	zh-CN
zhengzhixuefutejiaoshou	政治学福特教授	zh-CN
zhiduzhuyi	制度主义	zh-CN
zhiliangbuquedingxingqi	质量不确定性气	zh-CN
zhiyuanchengfazhe	志愿惩罚者	zh-CN
zhukeliangyuanqufen	主客两元区分	zh-CN
zhuliuguojitixililunpingshu	主流国际体系理论评述	zh-CN
zhuquanguojia	主权国家	zh-CN
zhutijianbentilun	主体间本体论	zh-CN
zhutijianshijianhuodong	主体间实践活动	zh-CN
zhutijianxing	主体间性	zh-CN
ziranzhuyi	自然主义	zh-CN
ziranzhuyijiangouzhuyi	自然主义建构主义	zh-CN
zongtiquanlijiegoujieshimoshi	总体权力结构解释模式	zh-CN
zuiyouzhanlue	最优战略	zh-CN
