# Gboard Dictionary version:1
anchengshi	安城市	zh-CN
anchuanmian	俺川面	zh-CN
andemian	安德面	zh-CN
andongshi	安东市	zh-CN
anqingdong	安清洞	zh-CN
anshanshi	安山市	zh-CN
anyangshi	安养市	zh-CN
aoxiandong	鳌仙洞	zh-CN
baiquandong	栢泉洞	zh-CN
baochengjun	宝城郡	zh-CN
baochuanshi	抱川市	zh-CN
baoenjun	报恩郡	zh-CN
baoningshi	保宁市	zh-CN
beijizhoujun	北济州郡	zh-CN
beishandong	北山洞	zh-CN
bendedong	本德洞	zh-CN
bilaidong	比来洞	zh-CN
biaoshanmian	表善面	zh-CN
bingshandong	柄山洞	zh-CN
bingyingmian	兵营面	zh-CN
bohudong	博湖洞	zh-CN
boyuedong	博月洞	zh-CN
caotangdong	草堂洞	zh-CN
cengpingjun	曾坪郡	zh-CN
changchengjun	长城郡	zh-CN
changchengpudong	长承浦洞	zh-CN
changdedong	长德洞	zh-CN
changdong	长洞	zh-CN
changludong	长录洞	zh-CN
changmumian	长木面	zh-CN
changningjun	昌宁郡	zh-CN
changshengpudong	长生浦洞	zh-CN
changshuidong	长水洞	zh-CN
changshuijun	长水郡	zh-CN
changxiandong	长岘洞	zh-CN
changxingjun	长兴郡	zh-CN
changyanmian	长延面	zh-CN
changyuanshi	昌原市	zh-CN
chengbeidong	城北洞	zh-CN
chengbeiqu	城北区	zh-CN
chengdongqu	城东区	zh-CN
chengnandong	城南洞	zh-CN
chengnanshi	城南市	zh-CN
chengneidong	城内洞	zh-CN
chengshanmian	城山面	zh-CN
chengshanyi	城山邑	zh-CN
chengtianmian	城田面	zh-CN
chengyandong	城岩洞	zh-CN
chibiandong	池边洞	zh-CN
chishandong	池山洞	zh-CN
chitingdong	池亭洞	zh-CN
chunchangjun	淳昌郡	zh-CN
chunchuanshi	春川市	zh-CN
cirenmian	慈仁面	zh-CN
dadong	大洞	zh-CN
dadong	达洞	zh-CN
dahedong	大禾洞	zh-CN
dajingyi	大静邑	zh-CN
dakoumian	大口面	zh-CN
damingdong	大明洞	zh-CN
dapingdong	大坪洞	zh-CN
daqiu	大邱	zh-CN
daqiuguangyushi	大邱广域市	zh-CN
dashandong	大山洞	zh-CN
dashanmian	大山面	zh-CN
datian	大田	zh-CN
datiandong	大田洞	zh-CN
datianguangyushi	大田广域市	zh-CN
datingdong	大亭洞	zh-CN
daxiangdong	大项洞	zh-CN
dazhidong	大峙洞	zh-CN
dazhudong	大诸洞	zh-CN
danshandong	淡山洞	zh-CN
danyangjun	丹阳郡	zh-CN
daodedong	道德洞	zh-CN
daofengqu	道峰区	zh-CN
daogudong	道谷洞	zh-CN
daohudong	道湖洞	zh-CN
daoquandong	道泉洞	zh-CN
daoshandong	道山洞	zh-CN
daoyanmian	道岩面	zh-CN
delindong	德林洞	zh-CN
depudong	德浦洞	zh-CN
deyandong	德岩洞	zh-CN
dengrendong	登任洞	zh-CN
dichuanshi	堤川市	zh-CN
diancundong	店村洞	zh-CN
dongbumian	东部面	zh-CN
dongdamenqu	东大门区	zh-CN
dongdouchuanshi	东豆川市	zh-CN
donghaishi	东海市	zh-CN
donghudong	东湖洞	zh-CN
donglaiqu	东莱区	zh-CN
donglindong	东林洞	zh-CN
dongshandong	东山洞	zh-CN
dongxiandong	东仙洞	zh-CN
doumomian	豆磨面	zh-CN
doushandong	斗山洞	zh-CN
doutingdong	斗亭洞	zh-CN
douwangdong	斗旺洞	zh-CN
dumudong	杜母洞	zh-CN
eyangdong	鹅阳洞	zh-CN
ezhoudong	鹅州洞	zh-CN
enpingqu	恩平区	zh-CN
fadong	法洞	zh-CN
fanfangdong	凡方洞	zh-CN
feiyadong	飞鸦洞	zh-CN
fengdedong	凤德洞	zh-CN
fenghuajun	奉化郡	zh-CN
fenglindong	凤林洞	zh-CN
fodingmian	佛顶面	zh-CN
foenmian	佛恩面	zh-CN
fuanjun	扶安郡	zh-CN
fuanmian	富安面	zh-CN
fuchuanshi	富川市	zh-CN
fugudong	夫谷洞	zh-CN
fulongdong	伏龙洞	zh-CN
fupingqu	富平区	zh-CN
fushan	釜山	zh-CN
fushanguangyushi	釜山广域市	zh-CN
fushanzhenqu	釜山镇区	zh-CN
fushuidong	芙水洞	zh-CN
fuyujun	扶馀郡	zh-CN
ganwumian	甘勿面	zh-CN
gaochangjun	高敞郡	zh-CN
gaochangjungushuimian	高敞郡古水面	zh-CN
gaochangyi	高敞邑	zh-CN
gaochengjun	高城郡	zh-CN
gaolijun	高丽郡	zh-CN
gaoxingjun	高兴郡	zh-CN
gaoyangshi	高阳市	zh-CN
getiandong	葛田洞	zh-CN
gongzhoushi	公州市	zh-CN
guchengjun	固城郡	zh-CN
guchengjun	谷城郡	zh-CN
gulongdong	古龙洞	zh-CN
gushadong	古沙洞	zh-CN
gushuimian	古水面	zh-CN
guandaojun	莞岛郡	zh-CN
guanyuequ	冠岳区	zh-CN
guangjinqu	广津区	zh-CN
guangmingshi	光明市	zh-CN
guangshandong	光山洞	zh-CN
guangyangshi	光阳市	zh-CN
guangzhou	光州	zh-CN
guangzhouguangyushi	光州广域市	zh-CN
guangzhoushi	广州市	zh-CN
guiweishi	龟尾市	zh-CN
guiyangdong	桂阳洞	zh-CN
guiyangqu	桂阳区	zh-CN
guochuanshi	果川市	zh-CN
hailimian	海里面	zh-CN
hainanjun	海南郡	zh-CN
haiyuntaiqu	海云台区	zh-CN
hedong	鹤洞	zh-CN
hedongjun	河东郡	zh-CN
henandong	河南洞	zh-CN
henanshi	河南市	zh-CN
heqingmian	河清面	zh-CN
heshunjun	和顺郡	zh-CN
heyangyi	河阳邑	zh-CN
hezaimian	河岾面	zh-CN
heishidong	黑石洞	zh-CN
hengchengjun	横城郡	zh-CN
hongchengjun	洪城郡	zh-CN
hongchuanjun	洪川郡	zh-CN
hongjidong	弘济洞	zh-CN
huachengshi	华城市	zh-CN
huachuanjun	华川郡	zh-CN
huadaomian	华道面	zh-CN
huatiandong	花田洞	zh-CN
huaishandong	淮山洞	zh-CN
huaishanjun	槐山郡	zh-CN
huaishanyi	槐山邑	zh-CN
huangchengdong	黄城洞	zh-CN
huanghudong	黄湖洞	zh-CN
huanglongdong	黄龙洞	zh-CN
huangquanjun	幌泉郡	zh-CN
jilongshi	鸡龙市	zh-CN
jixiangmian	吉祥面	zh-CN
jizhangjun	机张郡	zh-CN
jizhoudao	济州道	zh-CN
jizhoudaonanjizhoujun	济州道南济州郡	zh-CN
jizhoushi	济州市	zh-CN
jiadidong	甲堤洞	zh-CN
jiapingjun	加平郡	zh-CN
jiapingyi	加平邑	zh-CN
jianzhaodong	见召洞	zh-CN
jiangbeiqu	江北区	zh-CN
jiangdongdong	江东洞	zh-CN
jiangdongmian	江东面	zh-CN
jiangdongqu	江东区	zh-CN
jianghuajun	江华郡	zh-CN
jianghuayi	江华邑	zh-CN
jianglingshi	江陵市	zh-CN
jiangmendong	江门洞	zh-CN
jiangnanqu	江南区	zh-CN
jiangxiqu	江西区	zh-CN
jiangyuandao	江原道	zh-CN
jinchuanqu	衿川区	zh-CN
jindishi	金堤市	zh-CN
jinhaishi	金海市	zh-CN
jinhedong	锦鹤洞	zh-CN
jinjingqu	金井区	zh-CN
jinpushi	金浦市	zh-CN
jinquanshi	金泉市	zh-CN
jinshanjun	锦山郡	zh-CN
jinyandong	金岩洞	zh-CN
jinzhoushi	晋州市	zh-CN
jingjidao	京畿道	zh-CN
jingshanjun	旌善郡	zh-CN
jingyishi	井邑市	zh-CN
jiulangdong	九浪洞	zh-CN
jiulaoqu	九老区	zh-CN
jiulishi	九里市	zh-CN
juchangjun	居昌郡	zh-CN
jujimian	巨济面	zh-CN
jujishi	巨济市	zh-CN
jundongmian	郡东面	zh-CN
junpushi	军浦市	zh-CN
junweijun	军威郡	zh-CN
kaipudong	开浦洞	zh-CN
kaiyundong	开云洞	zh-CN
kangjinjun	康津郡	zh-CN
kangjinyi	康津邑	zh-CN
kongyinmian	孔音面	zh-CN
langudong	兰谷洞	zh-CN
lichuandong	梨川洞	zh-CN
lichuandong	里川洞	zh-CN
lichuanshi	利川市	zh-CN
lishanjun	礼山郡	zh-CN
lishuishi	里水市	zh-CN
lixiandong	栗岘洞	zh-CN
lixiandong	梨岘洞	zh-CN
liyandong	笠岩洞	zh-CN
lizhoujun	骊州郡	zh-CN
lianchoudong	連丑洞	zh-CN
lianchuanjun	涟川郡	zh-CN
liandiqu	莲堤区	zh-CN
liangumian	連谷面	zh-CN
lianshandong	连山洞	zh-CN
liangdaomian	良道面	zh-CN
liangdong	良洞	zh-CN
liangshandong	良山洞	zh-CN
liangshanshi	梁山市	zh-CN
liangsimian	两寺面	zh-CN
lingudong	林谷洞	zh-CN
lintangdong	林堂洞	zh-CN
lintangdong	林塘洞	zh-CN
lintijun	麟蹄郡	zh-CN
lingguangjun	灵光郡	zh-CN
lingpudong	菱浦洞	zh-CN
lingyanjun	灵岩郡	zh-CN
liuxidong	柳溪洞	zh-CN
longcendong	龙岑洞	zh-CN
longchengmian	龙城面	zh-CN
longdong	龙洞	zh-CN
longfengdong	龙峰洞	zh-CN
longgangdong	龙冈洞	zh-CN
longgudong	龙谷洞	zh-CN
longhudong	龙湖洞	zh-CN
longrenshi	龙仁市	zh-CN
longshanqu	龙山区	zh-CN
longyuandong	龙渊洞	zh-CN
lushandong	菉山洞	zh-CN
luyandong	鲁岩洞	zh-CN
luyuanqu	芦原区	zh-CN
lunshanshi	论山市	zh-CN
lunxiandong	论岘洞	zh-CN
luozhoushi	罗州市	zh-CN
lvchuandong	吕川洞	zh-CN
maliangmian	马良面	zh-CN
mapuqu	麻浦区	zh-CN
mashanshi	马山市	zh-CN
matiandong	麻田洞	zh-CN
maochangmian	茂长面	zh-CN
maozhujun	茂朱郡	zh-CN
meihudong	渼湖洞	zh-CN
meiyandong	梅岩洞	zh-CN
meiyindong	美音洞	zh-CN
miyangshi	密阳市	zh-CN
mingdaodong	明道洞	zh-CN
minghuadong	明花洞	zh-CN
mingzhidong	鸣旨洞	zh-CN
mingzhoudong	溟州洞	zh-CN
mupushi	木浦市	zh-CN
mushangdong	木上洞	zh-CN
nanbumian	南部面	zh-CN
nanchuanmian	南川面	zh-CN
nandongqu	南洞区	zh-CN
nanfangdong	南方洞	zh-CN
nanhaijun	南海郡	zh-CN
nanhuadong	南化洞	zh-CN
nanjizhoujun	南济州郡	zh-CN
nanmendong	南门洞	zh-CN
nanshandong	南山洞	zh-CN
nanshanmian	南山面	zh-CN
nanxianmian	南仙面	zh-CN
nanxiangjindong	南项津洞	zh-CN
nanyangzhoushi	南杨州市	zh-CN
nanyuanshi	南原市	zh-CN
nanyuanyi	南元邑	zh-CN
necidong	讷次洞	zh-CN
neidong	内洞	zh-CN
neigudong	内谷洞	zh-CN
neikemian	内可面	zh-CN
neishandong	内山洞	zh-CN
ningyuejun	寧越郡	zh-CN
niushandong	牛山洞	zh-CN
pingchangjun	平昌郡	zh-CN
pingcundong	坪村洞	zh-CN
pingshandong	坪山洞	zh-CN
pingzeshi	平泽市	zh-CN
pozhoushi	坡州市	zh-CN
puerdong	浦二洞	zh-CN
punandong	浦南洞	zh-CN
puxiangshi	浦项市	zh-CN
qigujun	漆谷郡	zh-CN
qiliangmian	七良面	zh-CN
qixingmian	七星面	zh-CN
qiaodongmian	乔洞面	zh-CN
qinganmian	青安面	zh-CN
qingchuanmian	青川面	zh-CN
qingdaojun	清道郡	zh-CN
qingliangdong	青良洞	zh-CN
qingpingmian	清平面	zh-CN
qingshanshi	庆山市	zh-CN
qingshangbeidao	庆尚北道	zh-CN
qingshangnandao	庆尚南道	zh-CN
qingsongjun	青松郡	zh-CN
qingtandong	清潭洞	zh-CN
qingyangjun	青阳郡	zh-CN
qingyuanjun	清原郡	zh-CN
qingzhoushi	庆州市	zh-CN
qingzhoushi	清州市	zh-CN
qiujingmian	邱井面	zh-CN
qiulijun	求礼郡	zh-CN
quanluobeidao	全罗北道	zh-CN
quanluonandao	全罗南道	zh-CN
quanzhoushi	全州市	zh-CN
quechuanmian	鹊川面	zh-CN
qunshanshi	群山市	zh-CN
renchuan	仁川	zh-CN
renchuanguangyushi	仁川广域市	zh-CN
renshijun	任实郡	zh-CN
rongzhoushi	荣州市	zh-CN
ruicaoqu	瑞草区	zh-CN
ruishanshi	瑞山市	zh-CN
sanbeidong	三北洞	zh-CN
sanchengdong	三成洞	zh-CN
sandaodong	三道洞	zh-CN
sanjudong	三巨洞	zh-CN
sanlidong	三豊洞	zh-CN
sannandong	三南洞	zh-CN
sanshandong	三山洞	zh-CN
sanshanmian	三山面	zh-CN
sanzhengdong	三政洞	zh-CN
sanzhishi	三陟市	zh-CN
shachuanmian	沙川面	zh-CN
shadengmian	沙等面	zh-CN
shahudong	沙湖洞	zh-CN
shalimian	沙梨面	zh-CN
shashangqu	沙上区	zh-CN
shaxiaqu	沙下区	zh-CN
shanchuanjun	陕川郡	zh-CN
shanmudong	山幕洞	zh-CN
shanqingjun	山清郡	zh-CN
shanshuidong	山水洞	zh-CN
shantingdong	山亭洞	zh-CN
shanyuedong	山月洞	zh-CN
shangfangdong	上方洞	zh-CN
shangkaidong	上开洞	zh-CN
shangshudong	上书洞	zh-CN
shangxiamian	上下面	zh-CN
shangzhoushi	尚州市	zh-CN
shenshidong	申石洞	zh-CN
shenggudong	生谷洞	zh-CN
shifengdong	石峰洞	zh-CN
shimandong	食满洞	zh-CN
shitingdong	士亭洞	zh-CN
shixingshi	始兴市	zh-CN
shouertebieshi	首尔特別市	zh-CN
shucaoshi	束草市	zh-CN
shuchuanjun	舒川郡	zh-CN
shuangyandong	双岩洞	zh-CN
shuiguandong	水莞洞	zh-CN
shuixidong	水西洞	zh-CN
shuiyingqu	水营区	zh-CN
shuiyuanshi	水原市	zh-CN
shuntianshi	顺天市	zh-CN
sichuanshi	泗川市	zh-CN
sidong	巳洞	zh-CN
songcundong	宋村洞	zh-CN
songcundong	松村洞	zh-CN
songdadong	松大洞	zh-CN
songhaimian	松海面	zh-CN
songhedong	松鹤洞	zh-CN
songpoqu	松坡区	zh-CN
songshandong	松山洞	zh-CN
songtingdong	松亭洞	zh-CN
songtingdong	松汀洞	zh-CN
songzhidong	松峙洞	zh-CN
sucundong	素村洞	zh-CN
taianjun	泰安郡	zh-CN
taibaishi	太白市	zh-CN
tanyangjun	潭阳郡	zh-CN
tangjinjun	唐津郡	zh-CN
tiananshi	天安市	zh-CN
tianchengdong	天城洞	zh-CN
tieyuanjun	铁原郡	zh-CN
tongquequ	铜雀区	zh-CN
tongyingshi	统营市	zh-CN
tundemian	屯德面	zh-CN
wacunmian	瓦村面	zh-CN
wadong	瓦洞	zh-CN
wanzhoujun	完州郡	zh-CN
wangdong	旺洞	zh-CN
wangshanmian	旺山面	zh-CN
weishan	蔚山	zh-CN
weishanguangyushi	蔚山广域市	zh-CN
weizhenjun	蔚珍郡	zh-CN
wenguangmian	文光面	zh-CN
wenpingdong	文坪洞	zh-CN
wenqingshi	闻庆市	zh-CN
wengjinjun	瓮津郡	zh-CN
wochuanjun	沃川郡	zh-CN
wuanjun	务安郡	zh-CN
wujingdong	梧井洞	zh-CN
wuqudong	无去洞	zh-CN
wushandong	乌山洞	zh-CN
wushanshi	乌山市	zh-CN
wuyundong	五云洞	zh-CN
xidamenqu	西大门区	zh-CN
xidaomian	西岛面	zh-CN
xifengdong	西峰洞	zh-CN
xigudong	细谷洞	zh-CN
xiguipushi	西归浦市	zh-CN
xishangdong	西上洞	zh-CN
xiaoutingdong	狎鸥亭洞	zh-CN
xiashandong	下山洞	zh-CN
xiananjun	咸安郡	zh-CN
xiandong	仙洞	zh-CN
xianpingjun	咸平郡	zh-CN
xianyandong	仙岩洞	zh-CN
xianyangjun	咸阳郡	zh-CN
xianyuanmian	仙源面	zh-CN
xiangyangjun	襄阳郡	zh-CN
xiaodong	校洞	zh-CN
xinanjun	新安郡	zh-CN
xinchangdong	新昌洞	zh-CN
xinchuandong	信川洞	zh-CN
xincundong	新村洞	zh-CN
xindaidong	新垈洞	zh-CN
xindong	新洞	zh-CN
xinhudong	新湖洞	zh-CN
xinjiadong	新佳洞	zh-CN
xinlinmian	新林面	zh-CN
xinlongdong	新龙洞	zh-CN
xinridong	新日洞	zh-CN
xinshadong	新沙洞	zh-CN
xintanjindong	新滩津洞	zh-CN
xintianmian	薪田面	zh-CN
xintingdong	新亭洞	zh-CN
xinxianyi	新县邑	zh-CN
xinxiaodong	新校洞	zh-CN
xinyuanmian	心元面	zh-CN
xingdemian	兴德面	zh-CN
xingneimian	星内面	zh-CN
xingsongmian	星松面	zh-CN
xingzhoujun	星州郡	zh-CN
xueyuemian	雪岳面	zh-CN
yaliangmian	押梁面	zh-CN
yashanmian	雅山面	zh-CN
yashanshi	牙山市	zh-CN
yancaomian	延草面	zh-CN
yanlimian	延豊面	zh-CN
yanqijun	燕岐郡	zh-CN
yanshouqu	延寿区	zh-CN
yanxiandong	雁岘洞	zh-CN
yangchuanqu	阳川区	zh-CN
yangkoujun	杨口郡	zh-CN
yangpingjun	杨平郡	zh-CN
yangzhoushi	杨州市	zh-CN
yaojidong	尧基洞	zh-CN
yeyindong	也音洞	zh-CN
yichengjun	义城郡	zh-CN
yineidong	邑内洞	zh-CN
yiningjun	宜寧郡	zh-CN
yisandong	驿三洞	zh-CN
yishanshi	益山市	zh-CN
yiwangshi	仪旺市	zh-CN
yiyuanbendong	逸院本洞	zh-CN
yiyuandong	逸院洞	zh-CN
yiyunmian	一运面	zh-CN
yizhengfushi	议政府市	zh-CN
yinchengjun	阴城郡	zh-CN
yingdaoqu	影岛区	zh-CN
yingdejun	盈德郡	zh-CN
yingyangjun	英阳郡	zh-CN
yongchuanshi	永川市	zh-CN
yongdengpuqu	永登浦区	zh-CN
yongtongjun	永同郡	zh-CN
yougudong	油谷洞	zh-CN
youshandong	幼山洞	zh-CN
yuchuandong	楡川洞	zh-CN
yuchuandong	玉川洞	zh-CN
yudong	玉洞	zh-CN
yugudong	玉谷洞	zh-CN
yulingjun	郁陵郡	zh-CN
yulongdong	鱼龙洞	zh-CN
yupudong	玉浦洞	zh-CN
yushandong	玉山洞	zh-CN
yuximian	玉溪面	zh-CN
yuanzhoushi	原州市	zh-CN
yuegudong	月谷洞	zh-CN
yueguidong	月桂洞	zh-CN
yuehupingdong	月呼坪洞	zh-CN
yuetiandong	月田洞	zh-CN
yunnandong	云南洞	zh-CN
yunshandong	云山洞	zh-CN
yunshuidong	云水洞	zh-CN
yuntingdong	云亭洞	zh-CN
zaoyongdong	造永洞	zh-CN
zhaoshoumian	沼寿面	zh-CN
zhenanjun	镇安郡	zh-CN
zhenchuanjun	鎭川郡	zh-CN
zhendaojun	珍岛郡	zh-CN
zhengudong	真谷洞	zh-CN
zhenhaishi	鎭海市	zh-CN
zhenliangyi	珍良邑	zh-CN
zhengpingdong	正坪洞	zh-CN
zhipingdong	芝坪洞	zh-CN
zhishidong	智士洞	zh-CN
zhizhudong	芝竹洞	zh-CN
zhongfangdong	中方洞	zh-CN
zhonglangqu	中浪区	zh-CN
zhonglidong	中里洞	zh-CN
zhongluqu	钟路区	zh-CN
zhongqingbeidao	忠清北道	zh-CN
zhongqingnandao	忠清南道	zh-CN
zhongshandong	中山洞	zh-CN
zhongzhoushi	忠州市	zh-CN
zhudong	苎洞	zh-CN
zhulindong	竹林洞	zh-CN
zhutongdong	竹同洞	zh-CN
zhuwenjinyi	注文津邑	zh-CN
zhuxuandong	竹轩洞	zh-CN
zigudong	紫谷洞	zh-CN
