# Gboard Dictionary version:1
acidaoli	阿此岛里	zh-CN
axiandong	阿岘洞	zh-CN
anchengshi	安城市	zh-CN
andongshi	安东市	zh-CN
anguodong	安国洞	zh-CN
anledong	安乐洞	zh-CN
anpingli	安平里	zh-CN
anshanshishangluqu	安山市尚录区	zh-CN
anshanshitanyuanqu	安山市檀园区	zh-CN
anyandong	安岩洞	zh-CN
anyangshidonganqu	安养市东安区	zh-CN
anyangshiwananqu	安养市万安区	zh-CN
aoshangli	鳌上里	zh-CN
aotouli	鳌头里	zh-CN
bapandong	八判洞	zh-CN
baijili	柏吉里	zh-CN
bailingmian	白翎面	zh-CN
baishidong	白石洞	zh-CN
baiyali	白牙里	zh-CN
banghuadong	傍花洞	zh-CN
baochengjun	宝城郡	zh-CN
baochuanshi	抱川市	zh-CN
baoenjun	报恩郡	zh-CN
baoningshi	保宁市	zh-CN
baoshuidong	宝水洞	zh-CN
beiaxiandong	北阿岘洞	zh-CN
beibuli	北布里	zh-CN
beicangdong	北仓洞	zh-CN
beichengdong	北城洞	zh-CN
beidaomian	北岛面	zh-CN
beijiazuodong	北加佐洞	zh-CN
beiqu	北区	zh-CN
beishengli	北省里	zh-CN
bendong	本洞	zh-CN
bidong	笔洞	zh-CN
biyundong	弼云洞	zh-CN
bingfangdong	兵房洞	zh-CN
bolameidong	波拉美洞	zh-CN
bulaodong	不老洞	zh-CN
canshibendong	蚕室本洞	zh-CN
canshidong	蚕室洞	zh-CN
canyuandong	蚕院洞	zh-CN
cangchuandong	沧川洞	zh-CN
cangdong	仓洞	zh-CN
canghouli	仓后里	zh-CN
cangli	仓里	zh-CN
cangqiandong	仓前洞	zh-CN
caochangdong	草场洞	zh-CN
caodong	草洞	zh-CN
caoliangdong	草粱洞	zh-CN
caoyidong	草邑洞	zh-CN
caozhili	草芝里	zh-CN
cengpingjun	曾坪郡	zh-CN
chadong	茶洞	zh-CN
changandong	长安洞	zh-CN
changanli	长安里	zh-CN
changanyi	长安邑	zh-CN
changchengdong	昌成洞	zh-CN
changchengjun	长城郡	zh-CN
changfengli	长峰里	zh-CN
changjidong	场基洞	zh-CN
changjiandong	长箭洞	zh-CN
changjingli	长井里	zh-CN
changlindong	长林洞	zh-CN
changningjun	昌宁郡	zh-CN
changqiaodong	长桥洞	zh-CN
changrongdong	昌荣洞	zh-CN
changshadong	长沙洞	zh-CN
changshandong	昌善洞	zh-CN
changshoudong	长寿洞	zh-CN
changshuijun	长水郡	zh-CN
changtianli	长田里	zh-CN
changweidong	长位洞	zh-CN
changxindong	昌信洞	zh-CN
changxingjun	长兴郡	zh-CN
changyuanshi	昌原市	zh-CN
changzhidong	长旨洞	zh-CN
chengbeidong	城北洞	zh-CN
chengbeiqu	城北区	zh-CN
chengdongqu	城东区	zh-CN
chengnanshipentangqu	城南市盆唐区	zh-CN
chengnanshishoujingqu	城南市寿井区	zh-CN
chengnanshizhongyuanqu	城南市中原区	zh-CN
chengneidong	城内洞	zh-CN
chengshandong	城山洞	zh-CN
chengxiandong	成贤洞	zh-CN
chongleili	崇雷里	zh-CN
chongrendong	崇仁洞	zh-CN
chongyidong	崇义洞	zh-CN
chuantouli	船头里	zh-CN
chunchangjun	淳昌郡	zh-CN
chunchuanshi	春川市	zh-CN
dabianli	大边里	zh-CN
dachangdong	大昌洞	zh-CN
dachengjun	达城郡	zh-CN
dadequ	大德区	zh-CN
dafangdong	大方洞	zh-CN
dagudong	大谷洞	zh-CN
dalindong	大林洞	zh-CN
dalongli	大龙里	zh-CN
daluoli	大罗里	zh-CN
dapingdong	大平洞	zh-CN
daqiaodong	大桥洞	zh-CN
daqingli	大青里	zh-CN
daqingmian	大青面	zh-CN
daqiu	大邱	zh-CN
dashanli	大山里	zh-CN
dashanli	达山里	zh-CN
datian	大田	zh-CN
datingdong	大厅洞	zh-CN
daxiqu	达西区	zh-CN
daxiandong	大岘洞	zh-CN
daxiangdong	大项洞	zh-CN
daxindong	大新洞	zh-CN
daxingdong	大兴洞	zh-CN
daxuedong	大学洞	zh-CN
dayuandong	大渊洞	zh-CN
dazaodong	大枣洞	zh-CN
dazhidong	大峙洞	zh-CN
dazhudong	大渚洞	zh-CN
danyangjun	丹阳郡	zh-CN
dangxiadong	当下洞	zh-CN
daochangli	道场里	zh-CN
daofengdong	道峰洞	zh-CN
daofengqu	道峰区	zh-CN
daogudong	道谷洞	zh-CN
daohedong	道禾洞	zh-CN
daolindong	道林洞	zh-CN
daoshendong	道诜洞	zh-CN
daoshidong	纛室洞	zh-CN
dechengli	德城里	zh-CN
dechuandong	德川洞	zh-CN
dejimian	德积面	zh-CN
depudong	德浦洞	zh-CN
depuli	德浦里	zh-CN
dexiali	德下里	zh-CN
dexianli	德仙里	zh-CN
dengcundong	登村洞	zh-CN
dichuanshi	堤川市	zh-CN
diannongdong	典农洞	zh-CN
dingguanmian	鼎冠面	zh-CN
dongbaili	冬柏里	zh-CN
dongbingkudong	东冰库洞	zh-CN
dongbuli	东部里	zh-CN
dongchongdong	东崇洞	zh-CN
dongchundong	东春洞	zh-CN
dongdamenqu	东大门区	zh-CN
dongdaxindong	东大新洞	zh-CN
dongdouchuanshi	东豆川市	zh-CN
dongguangdong	东光洞	zh-CN
donghaishi	东海市	zh-CN
dongjianli	东检里	zh-CN
donglaiqu	东莱区	zh-CN
dongmuli	东幕里	zh-CN
dongqiaodong	东桥洞	zh-CN
dongqu	东区	zh-CN
dongsandong	东三洞	zh-CN
dongshanli	东山里	zh-CN
dongxiandong	东仙洞	zh-CN
dongxiaomendong	东小门洞	zh-CN
dongyangdong	东阳洞	zh-CN
dongzidong	东子洞	zh-CN
doumingli	斗明里	zh-CN
dourandong	都染洞	zh-CN
douyunli	斗云里	zh-CN
duqiudong	杜邱洞	zh-CN
duncundong	遁村洞	zh-CN
dunyandong	敦岩洞	zh-CN
dunyidong	敦义洞	zh-CN
duodadong	多大洞	zh-CN
duonandong	多男洞	zh-CN
emeidong	峨嵋洞	zh-CN
enpingqu	恩平区	zh-CN
ercundong	二村洞	zh-CN
erguli	耳谷里	zh-CN
fanchuandong	凡川洞	zh-CN
fandong	樊洞	zh-CN
fanfangdong	凡方洞	zh-CN
fantiandong	凡田洞	zh-CN
fanyidong	凡一洞	zh-CN
fangbeibendong	方背本洞	zh-CN
fangbeidong	方背洞	zh-CN
fangguli	芳谷里	zh-CN
fanghedong	放鹤洞	zh-CN
fangshandong	芳山洞	zh-CN
fangyidong	芳夷洞	zh-CN
fangzhudong	放筑洞	zh-CN
fenghuajun	奉化郡	zh-CN
fenglindong	凤林洞	zh-CN
fengnadong	风纳洞	zh-CN
fengshaoli	凤韶里	zh-CN
fengtiandong	奉天洞	zh-CN
fengyidong	凤翼洞	zh-CN
fengyuandong	奉元洞	zh-CN
foenmian	佛恩面	zh-CN
foguangdong	佛光洞	zh-CN
fuanjun	扶安郡	zh-CN
fuchuanshisuosaqu	富川市索萨区	zh-CN
fuchuanshiwujingqu	富川市梧井区	zh-CN
fuchuanshiyuanmeiqu	富川市远美区	zh-CN
fugudong	釜谷洞	zh-CN
fujinli	富近里	zh-CN
fukaidong	富开洞	zh-CN
fumindong	富民洞	zh-CN
fupingdong	富平洞	zh-CN
fupingqu	富平区	zh-CN
fuquandong	福泉洞	zh-CN
furongdong	芙蓉洞	zh-CN
fushan	釜山	zh-CN
fushanzhenqu	釜山镇区	zh-CN
futiandong	釜田洞	zh-CN
fuyandong	付岩洞	zh-CN
fuyandong	釜岩洞	zh-CN
fuyindaoli	甫音岛里	zh-CN
fuyujun	扶余郡	zh-CN
ganchuandong	甘川洞	zh-CN
gantiandong	甘田洞	zh-CN
gangdong	港洞	zh-CN
gaochangjun	高敞郡	zh-CN
gaochengjun	高城郡	zh-CN
gaochidong	高尺洞	zh-CN
gaodedong	高德洞	zh-CN
gaolingjun	高灵郡	zh-CN
gaolingli	高陵里	zh-CN
gaoxingjun	高兴郡	zh-CN
gaoyangshideyangqu	高阳市德阳区	zh-CN
gaoyangshiyishandongqu	高阳市一山东区	zh-CN
gaoyangshiyishanxiqu	高阳市一山西区	zh-CN
gedong	蛤洞	zh-CN
geshandong	葛山洞	zh-CN
gexiandong	葛岘洞	zh-CN
geyuedong	葛月洞	zh-CN
gongcundong	公村洞	zh-CN
gongdong	宫洞	zh-CN
gongjingdong	宫井洞	zh-CN
gongpingdong	公平洞	zh-CN
gongzhoushi	公州市	zh-CN
guchengjun	固城郡	zh-CN
guchengjun	谷城郡	zh-CN
guchuanli	古川里	zh-CN
gucunli	古村里	zh-CN
guguili	古龟里	zh-CN
guzhandong	古栈洞	zh-CN
guafadong	挂法洞	zh-CN
guandaojun	莞岛郡	zh-CN
guandong	官洞	zh-CN
guanshuidong	观水洞	zh-CN
guantiedong	贯铁洞	zh-CN
guantingli	官厅里	zh-CN
guanxiaodong	官校洞	zh-CN
guanyuequ	冠岳区	zh-CN
guangandong	广安洞	zh-CN
guangfudong	光复洞	zh-CN
guangjinqu	广津区	zh-CN
guangmingshi	光明市	zh-CN
guangshanqu	光山区	zh-CN
guangxidong	光熙洞	zh-CN
guangyangshi	光阳市	zh-CN
guangzhou	光州	zh-CN
guangzhoushi	广州市	zh-CN
guangzhuangdong	广壮洞	zh-CN
guidong	桂洞	zh-CN
guipudong	龟浦洞	zh-CN
guishandong	桂山洞	zh-CN
guishandong	龟山洞	zh-CN
guiweishi	龟尾市	zh-CN
guiyangqu	桂阳区	zh-CN
guochuanshi	果川市	zh-CN
guohaidong	果海洞	zh-CN
haiandong	海岸洞	zh-CN
hainanjun	海南郡	zh-CN
haiyuntaiqu	海云台区	zh-CN
hanjianglu	汉江路	zh-CN
hannandong	汉南洞	zh-CN
hangdong	航洞	zh-CN
hedongjun	河东郡	zh-CN
hegubendong	和谷本洞	zh-CN
hegudong	和谷洞	zh-CN
hejingdong	合井洞	zh-CN
heli	鹤里	zh-CN
henanshi	河南市	zh-CN
heshanmian	河嶦面	zh-CN
heshunjun	和顺郡	zh-CN
heyidong	鹤翼洞	zh-CN
hezhangdong	鹤章洞	zh-CN
hezhongdong	贺中洞	zh-CN
heishidong	黑石洞	zh-CN
hengchengjun	横城郡	zh-CN
hengxili	横溪里	zh-CN
hongbadong	红把洞	zh-CN
hongchengjun	洪城郡	zh-CN
hongchuanjun	洪川郡	zh-CN
hongendong	弘恩洞	zh-CN
hongjidong	弘济洞	zh-CN
hongyidong	弘益洞	zh-CN
hongzhidong	弘智洞	zh-CN
houyandong	厚岩洞	zh-CN
huachengshi	华城市	zh-CN
huachuanjun	华川郡	zh-CN
huadaomian	华道面	zh-CN
huadong	花洞	zh-CN
huamingdong	华明洞	zh-CN
huapingdong	花平洞	zh-CN
huashuidong	花水洞	zh-CN
huatiandong	花田洞	zh-CN
huatianli	花田里	zh-CN
huayangdong	华阳洞	zh-CN
huaishanjun	槐山郡	zh-CN
huaitingdong	槐亭洞	zh-CN
huanghedong	黄鹤洞	zh-CN
huangqingli	黄清里	zh-CN
huidongdong	回东洞	zh-CN
huihuadong	惠化洞	zh-CN
huijidong	回基洞	zh-CN
huiqingdong	徽庆洞	zh-CN
huixiandong	会贤洞	zh-CN
jichuanli	吉川里	zh-CN
jidong	吉洞	zh-CN
jijidong	祭基洞	zh-CN
jijili	吉稷里	zh-CN
jilongshi	鸡龙市	zh-CN
jishandong	积善洞	zh-CN
jitingli	吉亭里	zh-CN
jixiangmian	吉祥面	zh-CN
jiyindong	吉音洞	zh-CN
jizhangjun	机张郡	zh-CN
jizhangyi	机张邑	zh-CN
jizhoudao	济州道	zh-CN
jizhoushi	济州市	zh-CN
jiachuanli	甲串里	zh-CN
jiahuidong	嘉会洞	zh-CN
jialifengdong	加里峰洞	zh-CN
jiapingjun	加平郡	zh-CN
jiashandong	加山洞	zh-CN
jiatingdong	佳亭洞	zh-CN
jiayangdong	加阳洞	zh-CN
jiayedong	伽倻洞	zh-CN
jiayili	加乙里	zh-CN
jiazuodong	佳佐洞	zh-CN
jianshidong	间石洞	zh-CN
jianzhidong	坚志洞	zh-CN
jiangbeiqu	江北区	zh-CN
jiangdongdong	江东洞	zh-CN
jiangdongqu	江东区	zh-CN
jianghuajun	江华郡	zh-CN
jianghuayi	江华邑	zh-CN
jianglingshi	江陵市	zh-CN
jiangnanqu	江南区	zh-CN
jiangxiqu	江西区	zh-CN
jiangxingli	将兴里	zh-CN
jiangyidong	江一洞	zh-CN
jiangyuandao	江原道	zh-CN
jiangzhongdong	奖忠洞	zh-CN
jinchengdong	金城洞	zh-CN
jinchuanqu	衿川区	zh-CN
jindishi	金堤市	zh-CN
jingudong	金谷洞	zh-CN
jinhaishi	金海市	zh-CN
jinhudong	金湖洞	zh-CN
jinjingqu	金井区	zh-CN
jinkuandong	津宽洞	zh-CN
jinpushi	金浦市	zh-CN
jinquanshi	金泉市	zh-CN
jinshanjun	锦山郡	zh-CN
jinsidong	锦丝洞	zh-CN
jinyueli	锦月里	zh-CN
jinzhoushi	晋州市	zh-CN
jingdong	京洞	zh-CN
jingjidao	京畿道	zh-CN
jingshanjun	旌善郡	zh-CN
jingxidong	景西洞	zh-CN
jingyishi	井邑市	zh-CN
jiujidong	旧基洞	zh-CN
jiulangdong	九浪洞	zh-CN
jiulaodong	九老洞	zh-CN
jiulaoqu	九老区	zh-CN
jiulishi	九里市	zh-CN
jiupingdong	旧平洞	zh-CN
jiuqili	九七里	zh-CN
jiuruidong	久瑞洞	zh-CN
jiushandong	九山洞	zh-CN
jiushuidong	旧水洞	zh-CN
jiuyidong	九宜洞	zh-CN
jiuyuedong	九月洞	zh-CN
juchangjun	居昌郡	zh-CN
judidong	巨堤洞	zh-CN
juhuali	菊花里	zh-CN
jujishi	巨济市	zh-CN
juxiandong	橘岘洞	zh-CN
juyudong	巨余洞	zh-CN
jueyeli	掘业里	zh-CN
junpushi	军浦市	zh-CN
junweijun	军威郡	zh-CN
junzidong	君子洞	zh-CN
kaifengdong	开峰洞	zh-CN
kaihuadong	开花洞	zh-CN
kaipudong	开浦洞	zh-CN
kaiqindong	开琴洞	zh-CN
kanmandong	戡蛮洞	zh-CN
kangjinjun	康津郡	zh-CN
kelebendong	可乐本洞	zh-CN
keledong	可乐洞	zh-CN
kongdedong	孔德洞	zh-CN
konggangdong	空港洞	zh-CN
konglingdong	孔陵洞	zh-CN
kuanxundong	宽勋洞	zh-CN
langudong	兰谷洞	zh-CN
lanjingli	兰井里	zh-CN
lanxiangdong	兰香洞	zh-CN
laogushandong	老姑山洞	zh-CN
laopudong	老圃洞	zh-CN
laowudidong	老梧地洞	zh-CN
lemindong	乐民洞	zh-CN
leyuandong	乐园洞	zh-CN
lengjingli	冷井里	zh-CN
lengquandong	冷泉洞	zh-CN
lichuanshi	利川市	zh-CN
lihuadong	梨花洞	zh-CN
lijiangli	梨江里	zh-CN
lijingdong	笠井洞	zh-CN
lilinli	礼林里	zh-CN
limendong	里门洞	zh-CN
limudong	栗木洞	zh-CN
liquanjun	礼泉郡	zh-CN
lishanjun	礼山郡	zh-CN
lishuishi	丽水市	zh-CN
litaiyuandong	梨泰院洞	zh-CN
lixiandong	栗岘洞	zh-CN
lizhidong	礼智洞	zh-CN
lizhoujun	骊州郡	zh-CN
lianchidong	莲池洞	zh-CN
lianchuanjun	涟川郡	zh-CN
liandiqu	莲堤区	zh-CN
liangudong	廉谷洞	zh-CN
lianguili	莲龟里	zh-CN
lianhuali	莲花里	zh-CN
lianjiandong	莲建洞	zh-CN
lianshandong	莲山洞	zh-CN
lianxidong	连喜洞	zh-CN
lianzhidong	莲智洞	zh-CN
liangcaidong	良才洞	zh-CN
liangdaomian	良道面	zh-CN
liangjiali	两甲里	zh-CN
liangshanshi	梁山市	zh-CN
liangsili	两寺里	zh-CN
liangsimian	两寺面	zh-CN
linguli	林谷里	zh-CN
linhedong	林鹤洞	zh-CN
linjili	林基里	zh-CN
linlangli	林浪里	zh-CN
lintijun	麟蹄郡	zh-CN
lingdong	陵洞	zh-CN
lingguangjun	灵光郡	zh-CN
lingneili	陵内里	zh-CN
lingquandong	灵泉洞	zh-CN
lingxingmian	灵兴面	zh-CN
lingyanjun	灵岩郡	zh-CN
liudong	柳洞	zh-CN
longchuanli	龙川里	zh-CN
longdong	龙洞	zh-CN
longhudong	龙湖洞	zh-CN
longjiangdong	龙江洞	zh-CN
longjingli	龙井里	zh-CN
longmendong	龙门洞	zh-CN
longrenshichurenqu	龙仁市处仁区	zh-CN
longrenshiqixingqu	龙仁市器兴区	zh-CN
longrenshishuizhiqu	龙仁市水枝区	zh-CN
longshanqu	龙山区	zh-CN
longtadong	龙踏洞	zh-CN
longtangdong	龙塘洞	zh-CN
longtoudong	龙头洞	zh-CN
longxiandong	龙岘洞	zh-CN
longxiuli	龙岫里	zh-CN
longzhaoli	龙沼里	zh-CN
longzongdong	龙宗洞	zh-CN
loushangdong	楼上洞	zh-CN
louxiadong	楼下洞	zh-CN
luliangjindong	鹭梁津洞	zh-CN
lupandong	碌磻洞	zh-CN
lushandong	菉山洞	zh-CN
luyuanqu	芦原区	zh-CN
lunshanshi	论山市	zh-CN
lunxiandong	论岘洞	zh-CN
luoxingdaidong	落星垈洞	zh-CN
luozhoushi	罗州市	zh-CN
lvdingli	率丁里	zh-CN
machangdong	马场洞	zh-CN
machuandong	马川洞	zh-CN
magudong	麻谷洞	zh-CN
mapudong	麻浦洞	zh-CN
mapuqu	麻浦区	zh-CN
mashanshi	马山市	zh-CN
matiandong	麻田洞	zh-CN
maoluodong	毛罗洞	zh-CN
maotianli	茅田里	zh-CN
maozhujun	茂朱郡	zh-CN
meiheli	梅鹤里	zh-CN
meiqindong	美芹洞	zh-CN
meixingdong	美星洞	zh-CN
meiyindong	美音洞	zh-CN
meiyinli	煤音里	zh-CN
menxiandong	门岘洞	zh-CN
miadong	弥阿洞	zh-CN
mifali	弥法里	zh-CN
miyangshi	密阳市	zh-CN
mianmudong	面牧洞	zh-CN
miaodong	庙洞	zh-CN
minyuedong	民乐洞	zh-CN
mingcangdong	鸣藏洞	zh-CN
mingdong	明洞	zh-CN
minglili	鸣礼里	zh-CN
minglundong	明伦洞	zh-CN
mingyidong	明逸洞	zh-CN
mingzhidong	鸣旨洞	zh-CN
modaoli	末岛里	zh-CN
modong	墨洞	zh-CN
mojingdong	墨井洞	zh-CN
mudaoli	慕岛里	zh-CN
mudong	木洞	zh-CN
mupushi	木浦市	zh-CN
mushuangdong	木霜洞	zh-CN
naichengli	艿城里	zh-CN
nanbeidong	南北洞	zh-CN
nanbuli	南部里	zh-CN
nancangdong	南仓洞	zh-CN
nanchuandong	南川洞	zh-CN
nancundong	南村洞	zh-CN
nandamenlu	南大门路	zh-CN
nandongqu	南洞区	zh-CN
nanfumindong	南富民洞	zh-CN
nangangdong	南港洞	zh-CN
nanhaijun	南海郡	zh-CN
nanjiazuodong	南加佐洞	zh-CN
nanpudong	南浦洞	zh-CN
nanpuli	南浦里	zh-CN
nanqu	南区	zh-CN
nanshandong	南山洞	zh-CN
nanshanli	南山里	zh-CN
nanxiandong	南岘洞	zh-CN
nanxuedong	南学洞	zh-CN
nanyangzhoushi	南杨州市	zh-CN
nanyingdong	南营洞	zh-CN
nanyuanshi	南原市	zh-CN
necidong	讷次洞	zh-CN
neiboshandong	内钵山洞	zh-CN
neidong	内洞	zh-CN
neigudong	内谷洞	zh-CN
neikemian	内可面	zh-CN
neili	内里	zh-CN
neixudong	内需洞	zh-CN
neizidong	内资洞	zh-CN
ningyuejun	宁越郡	zh-CN
niuerdong	牛耳洞	zh-CN
niumiandong	牛眠洞	zh-CN
niuyandong	牛岩洞	zh-CN
ouxiali	鸥下里	zh-CN
panlongli	盘龙里	zh-CN
panpubendong	盘浦本洞	zh-CN
panpudong	盘浦洞	zh-CN
panrudong	盘如洞	zh-CN
pansongdong	盘松洞	zh-CN
penglaidong	蓬莱洞	zh-CN
pingcangdong	平仓洞	zh-CN
pingchangjun	平昌郡	zh-CN
pingdong	坪洞	zh-CN
pingdong	平洞	zh-CN
pingshanli	屏山里	zh-CN
pingzeshi	平泽市	zh-CN
pozhoushi	坡州市	zh-CN
pucundong	朴村洞	zh-CN
puguangdong	普光洞	zh-CN
pumendong	普门洞	zh-CN
puxiangshibeiqu	浦项市北区	zh-CN
puxiangshinanqu	浦项市南区	zh-CN
qidong	齐洞	zh-CN
qigujun	漆谷郡	zh-CN
qilongli	奇龙里	zh-CN
qishandong	漆山洞	zh-CN
qiyanli	七岩里	zh-CN
qiandong	钱洞	zh-CN
qianhudong	千户洞	zh-CN
qianpingli	乾坪里	zh-CN
qianyandong	黔岩洞	zh-CN
qiaobeidong	桥北洞	zh-CN
qiaodongmian	乔洞面	zh-CN
qiaonandong	桥南洞	zh-CN
qiaoshanli	桥山里	zh-CN
qingchuandong	清川洞	zh-CN
qingdaojun	清道郡	zh-CN
qingguangli	青光里	zh-CN
qinghedong	青鹤洞	zh-CN
qingjiangli	清江里	zh-CN
qingjindong	清进洞	zh-CN
qinglianglidong	清凉里洞	zh-CN
qinglindong	青林洞	zh-CN
qinglongdong	青龙洞	zh-CN
qingpodong	青坡洞	zh-CN
qingshanshi	庆山市	zh-CN
qingshangbeidao	庆尚北道	zh-CN
qingshangnandao	庆尚南道	zh-CN
qingsongjun	青松郡	zh-CN
qingtandong	清潭洞	zh-CN
qingyandong	清岩洞	zh-CN
qingyangjun	青阳郡	zh-CN
qingyuanjun	清原郡	zh-CN
qingyundong	庆云洞	zh-CN
qingyundong	清云洞	zh-CN
qingzhoushi	庆州市	zh-CN
qingzhoushishangdangqu	清州市上党区	zh-CN
qingzhoushixingdequ	清州市兴德区	zh-CN
qiulijun	求礼郡	zh-CN
quanluobeidao	全罗北道	zh-CN
quanluonandao	全罗南道	zh-CN
quannongdong	劝农洞	zh-CN
quanzhoushidejinqu	全州市德津区	zh-CN
quanzhoushiwanshanqu	全州市完山区	zh-CN
quetiandong	鹊田洞	zh-CN
quetianruiyundong	鹊田瑞云洞	zh-CN
qunshanshi	群山市	zh-CN
renchuan	仁川	zh-CN
renshanli	仁山里	zh-CN
renshijun	任实郡	zh-CN
renshili	仁士里	zh-CN
renshoudong	仁寿洞	zh-CN
rensidong	仁寺洞	zh-CN
renxiandong	仁宪洞	zh-CN
renxiandong	仁岘洞	zh-CN
renyidong	仁义洞	zh-CN
riguangmian	日光面	zh-CN
rixindong	日新洞	zh-CN
rongzhoushi	荣州市	zh-CN
ruchengqu	儒城区	zh-CN
rucili	如此里	zh-CN
ruyidaodong	汝矣岛洞	zh-CN
ruicaodong	瑞草洞	zh-CN
ruicaoqu	瑞草区	zh-CN
ruilindong	瑞麟洞	zh-CN
ruishanshi	瑞山市	zh-CN
ruiyundong	瑞云洞	zh-CN
sanchengdong	三成洞	zh-CN
sanchengli	三成里	zh-CN
sanjiaodong	三角洞	zh-CN
sanjiaoshandong	三角山洞	zh-CN
sanjuli	三巨里	zh-CN
sanledong	三乐洞	zh-CN
sanqingdong	三清洞	zh-CN
sanshandong	三山洞	zh-CN
sanshanmian	三山面	zh-CN
sanshengdong	三圣洞	zh-CN
sanshengli	三圣里	zh-CN
santiandong	三田洞	zh-CN
santongyanli	三同岩里	zh-CN
sanxiandong	三仙洞	zh-CN
sanxianli	三仙里	zh-CN
sanxingli	三兴里	zh-CN
sanyangdong	三阳洞	zh-CN
sanzhishi	三陟市	zh-CN
shadong	沙洞	zh-CN
shajindong	沙斤洞	zh-CN
shaqili	沙器里	zh-CN
shashangqu	沙上区	zh-CN
shaxiaqu	沙下区	zh-CN
shanchuanjun	陕川郡	zh-CN
shangudong	山谷洞	zh-CN
shanlindong	善隣洞	zh-CN
shanlindong	山林洞	zh-CN
shanqingjun	山清郡	zh-CN
shanquandong	山泉洞	zh-CN
shangdaodong	上道洞	zh-CN
shangdaoli	上道里	zh-CN
shangfangli	上坊里	zh-CN
shangfengdong	上凤洞	zh-CN
shangli	上里	zh-CN
shanglongli	上龙里	zh-CN
shangshuidong	上水洞	zh-CN
shangwangshilidong	上往十里洞	zh-CN
shangxidong	上溪洞	zh-CN
shangyandong	上岩洞	zh-CN
shangyedong	上野洞	zh-CN
shangyidong	上一洞	zh-CN
shangyuegudong	上月谷洞	zh-CN
shangzhoushi	尚州市	zh-CN
shejidong	社稷洞	zh-CN
shetangdong	舍堂洞	zh-CN
shengudong	深谷洞	zh-CN
shenjingli	神井里	zh-CN
shentangli	申唐里	zh-CN
shengfengli	升凤里	zh-CN
shenggudong	生谷洞	zh-CN
shengshuidong	圣水洞	zh-CN
shichuandong	始川洞	zh-CN
shichuandong	石串洞	zh-CN
shicundong	石村洞	zh-CN
shidaoli	矢岛里	zh-CN
shijingdong	十井洞	zh-CN
shilangli	侍郎里	zh-CN
shimandong	食满洞	zh-CN
shinandong	石南洞	zh-CN
shipuli	石浦里	zh-CN
shishanli	石山里	zh-CN
shitaidong	石坮洞	zh-CN
shixingdong	始兴洞	zh-CN
shixingshi	始兴市	zh-CN
shizonglu	世宗路	zh-CN
shouandong	寿安洞	zh-CN
shouchengqu	寿城区	zh-CN
shouer	首尔	zh-CN
shoushandong	寿山洞	zh-CN
shousongdong	寿松洞	zh-CN
shucaoshi	束草市	zh-CN
shuchuanjun	舒川郡	zh-CN
shudong	书洞	zh-CN
shuyuandong	书院洞	zh-CN
shuanglindong	双林洞	zh-CN
shuangmendong	双门洞	zh-CN
shuibiaodong	水标洞	zh-CN
shuijingdong	水晶洞	zh-CN
shuisedong	水色洞	zh-CN
shuixidong	水西洞	zh-CN
shuixiadong	水下洞	zh-CN
shuiyingdong	水营洞	zh-CN
shuiyingqu	水营区	zh-CN
shuiyudong	水逾洞	zh-CN
shuiyuanshibadaqu	水原市八达区	zh-CN
shuiyuanshichanganqu	水原市长安区	zh-CN
shuiyuanshilingtongqu	水原市灵通区	zh-CN
shuiyuanshiquanshanqu	水原市劝善区	zh-CN
shuntianshi	顺天市	zh-CN
sichuanshi	泗川市	zh-CN
sijiandong	司谏洞	zh-CN
songdaodong	松岛洞	zh-CN
songhaimian	松海面	zh-CN
songhedong	松鹤洞	zh-CN
songlindong	松林洞	zh-CN
songpodong	松坡洞	zh-CN
songpoqu	松坡区	zh-CN
songquandong	松泉洞	zh-CN
songtingdong	松亭洞	zh-CN
songtingli	松亭里	zh-CN
songxiandong	松岘洞	zh-CN
songyuedong	松月洞	zh-CN
songzhongdong	松中洞	zh-CN
tadong	沓洞	zh-CN
tashilidong	踏十里洞	zh-CN
taianjun	泰安郡	zh-CN
taibaishi	太白市	zh-CN
taipinglu	太平路	zh-CN
tanyangjun	潭阳郡	zh-CN
tanggandong	堂甘洞	zh-CN
tangjinjun	唐津郡	zh-CN
tanglidong	堂里洞	zh-CN
tangrendong	唐仁洞	zh-CN
tangshandong	堂山洞	zh-CN
tangshanli	堂山里	zh-CN
tangsheli	堂社里	zh-CN
tangzhudong	唐珠洞	zh-CN
taohuadong	桃花洞	zh-CN
taolindong	桃林洞	zh-CN
taoyuandong	桃园洞	zh-CN
taoyuandong	桃源洞	zh-CN
tifudong	体府洞	zh-CN
tiananshidongnanqu	天安市东南区	zh-CN
tiananshixibeiqu	天安市西北区	zh-CN
tianchengdong	天城洞	zh-CN
tianpudong	田浦洞	zh-CN
tianrandong	天然洞	zh-CN
tianwangdong	天旺洞	zh-CN
tiemamian	铁马面	zh-CN
tieshanli	铁山里	zh-CN
tieyuanjun	铁原郡	zh-CN
tongquedong	铜雀洞	zh-CN
tongquequ	铜雀区	zh-CN
tongrendong	通仁洞	zh-CN
tongyidong	通义洞	zh-CN
tongyingshi	统营市	zh-CN
tuchengdong	土城洞	zh-CN
tushandong	秃山洞	zh-CN
tutingdong	土亭洞	zh-CN
wayuli	瓦余里	zh-CN
waiboshandong	外钵山洞	zh-CN
waili	外里	zh-CN
waipuli	外浦里	zh-CN
wandedong	万德洞	zh-CN
wanhuali	万化里	zh-CN
wanlidong	万里洞	zh-CN
wanshidong	万石洞	zh-CN
wanshoudong	万寿洞	zh-CN
wanzhoujun	完州郡	zh-CN
wangjidong	旺吉洞	zh-CN
wangmeidong	望美洞	zh-CN
wangshilidong	往十里洞	zh-CN
wangyoubendong	忘忧本洞	zh-CN
wangyoudong	忘忧洞	zh-CN
wangyuandong	望远洞	zh-CN
wangyueli	望月里	zh-CN
weidaoli	蔚岛里	zh-CN
weishan	蔚山	zh-CN
weizhenjun	蔚珍郡	zh-CN
weizhoujun	蔚州郡	zh-CN
wendongli	文东里	zh-CN
wenhedong	文鹤洞	zh-CN
wenjiali	文甲里	zh-CN
wenjingdong	文井洞	zh-CN
wenlaidong	文来洞	zh-CN
wenpeidong	文培洞	zh-CN
wenqingshi	闻庆市	zh-CN
wenquandong	温泉洞	zh-CN
wenshanli	文山里	zh-CN
wenshuidong	温水洞	zh-CN
wenshuili	温水里	zh-CN
wenzhongli	文中里	zh-CN
wengjinjun	瓮津郡	zh-CN
wochuanjun	沃川郡	zh-CN
wolongdong	卧龙洞	zh-CN
wuanjun	务安郡	zh-CN
wugudong	五谷洞	zh-CN
wuhedong	舞鹤洞	zh-CN
wuheli	舞鹤里	zh-CN
wuli	五里	zh-CN
wuliudong	梧柳洞	zh-CN
wulundong	五伦洞	zh-CN
wulundong	五轮洞	zh-CN
wuqiaodong	武桥洞	zh-CN
wuqindong	梧琴洞	zh-CN
wushanshi	乌山市	zh-CN
wuyidong	舞衣洞	zh-CN
wuyuedong	毋岳洞	zh-CN
wuzhaodong	五钊洞	zh-CN
wuzhuangdong	五壮洞	zh-CN
xibingkudong	西冰库洞	zh-CN
xibuli	西部里	zh-CN
xichangdong	西昌洞	zh-CN
xidamenqu	西大门区	zh-CN
xidaxindong	西大新洞	zh-CN
xidaomian	西岛面	zh-CN
xigudong	细谷洞	zh-CN
xiguipushi	西归浦市	zh-CN
xihanli	西汉里	zh-CN
xijianli	西检里	zh-CN
xijiedong	西界洞	zh-CN
xilindong	西林洞	zh-CN
ximaoli	席毛里	zh-CN
xipuli	西浦里	zh-CN
xiqiaodong	西桥洞	zh-CN
xiqu	西区	zh-CN
xixiaomendong	西小门洞	zh-CN
xiadaoli	下道里	zh-CN
xiaduandong	下端洞	zh-CN
xiali	下里	zh-CN
xiaoutingdong	狎鸥亭洞	zh-CN
xiawangshilidong	下往十里洞	zh-CN
xiaxidong	下溪洞	zh-CN
xiayedong	下野洞	zh-CN
xiayili	霞逸里	zh-CN
xiayuegudong	下月谷洞	zh-CN
xiananjun	咸安郡	zh-CN
xiancaili	仙才里	zh-CN
xiandidong	岘底洞	zh-CN
xiandong	仙洞	zh-CN
xianhedong	仙鹤洞	zh-CN
xianhuadong	仙花洞	zh-CN
xianpingjun	咸平郡	zh-CN
xianxingli	仙杏里	zh-CN
xianyangjun	咸阳郡	zh-CN
xianyuanmian	仙源面	zh-CN
xianzhuchidong	仙住池洞	zh-CN
xiangyangjun	襄阳郡	zh-CN
xiaochangdong	孝昌洞	zh-CN
xiaogongdong	小公洞	zh-CN
xiaoli	校里	zh-CN
xiaoqingli	小青里	zh-CN
xiaotidong	孝悌洞	zh-CN
xiaoxingdong	晓星洞	zh-CN
xiaoyanli	孝岩里	zh-CN
xiaoyanpingli	小延坪里	zh-CN
xiaozidong	孝子洞	zh-CN
xinanjun	新安郡	zh-CN
xincangdong	新仓洞	zh-CN
xinchangdong	新昌洞	zh-CN
xinchuandong	新川洞	zh-CN
xinchuanli	新川里	zh-CN
xincundong	新村洞	zh-CN
xindafangdong	新大方洞	zh-CN
xindaoli	信岛里	zh-CN
xindaolindong	新道林洞	zh-CN
xinfengli	新凤里	zh-CN
xinhudong	新湖洞	zh-CN
xinjidong	新吉洞	zh-CN
xinjingdong	新井洞	zh-CN
xinkongdedong	新孔德洞	zh-CN
xinlindong	新林洞	zh-CN
xinmenli	新门里	zh-CN
xinmenlu	新门路	zh-CN
xinneidong	新内洞	zh-CN
xinpingdong	新平洞	zh-CN
xinpingli	新坪里	zh-CN
xinpudong	新浦洞	zh-CN
xinqidong	新契洞	zh-CN
xinqiaodong	新桥洞	zh-CN
xinsanli	新三里	zh-CN
xinshadong	新沙洞	zh-CN
xinshedong	新设洞	zh-CN
xinshengdong	新生洞	zh-CN
xinshidong	新士洞	zh-CN
xinshuidong	新水洞	zh-CN
xinsidong	新寺洞	zh-CN
xintangdong	新堂洞	zh-CN
xintingdong	新亭洞	zh-CN
xinxiandong	新仙洞	zh-CN
xinxiandong	新岘洞	zh-CN
xinxianli	新岘里	zh-CN
xinxingdong	新兴洞	zh-CN
xinyingdong	新营洞	zh-CN
xinyuandong	新源洞	zh-CN
xinyuandong	新院洞	zh-CN
xinyuedong	新月洞	zh-CN
xingcundong	杏村洞	zh-CN
xingrendong	兴仁洞	zh-CN
xingtangdong	杏堂洞	zh-CN
xingwangli	兴旺里	zh-CN
xingyundong	幸运洞	zh-CN
xingzhoujun	星州郡	zh-CN
xiongchuanli	熊川里	zh-CN
xuanshidong	玄石洞	zh-CN
xunhedong	巡和洞	zh-CN
xunjingdong	薰井洞	zh-CN
yashanshi	牙山市	zh-CN
yancangdong	盐仓洞	zh-CN
yangongdong	严弓洞	zh-CN
yanli	烟里	zh-CN
yanlidong	盐里洞	zh-CN
yannandong	岩南洞	zh-CN
yannandong	延南洞	zh-CN
yanpingmian	延坪面	zh-CN
yanqijun	燕岐郡	zh-CN
yanshoudong	延寿洞	zh-CN
yanshouqu	延寿区	zh-CN
yansidong	岩寺洞	zh-CN
yanxidong	延禧洞	zh-CN
yangchuanqu	阳川区	zh-CN
yanghuadong	杨花洞	zh-CN
yangkoujun	杨口郡	zh-CN
yangpingdong	杨坪洞	zh-CN
yangpingjun	扬平郡	zh-CN
yangtingdong	杨亭洞	zh-CN
yangwuli	阳五里	zh-CN
yangzhoushi	杨州市	zh-CN
yichangdong	艺场洞	zh-CN
yichengjun	义城郡	zh-CN
yichuanli	伊川里	zh-CN
yicundong	驿村洞	zh-CN
yiguandong	艺馆洞	zh-CN
yineili	邑内里	zh-CN
yiningjun	宜宁郡	zh-CN
yisandong	驿三洞	zh-CN
yishandong	益善洞	zh-CN
yishanshi	益山市	zh-CN
yiwangdong	乙旺洞	zh-CN
yiwangshi	仪旺市	zh-CN
yiyuanbendong	逸院本洞	zh-CN
yiyuandong	逸院洞	zh-CN
yizhengfushi	议政府市	zh-CN
yizhilu	乙支路	zh-CN
yizhoulu	义州路	zh-CN
yizuoli	伊作里	zh-CN
yinchengjun	阴城郡	zh-CN
yinchuandong	殷川洞	zh-CN
yinhuoli	寅火里	zh-CN
yingdaoqu	影岛区	zh-CN
yingdejun	盈德郡	zh-CN
yingfengdong	鹰峰洞	zh-CN
yingxiandong	瀛仙洞	zh-CN
yingyandong	鹰岩洞	zh-CN
yingyangjun	英阳郡	zh-CN
yingzhoudong	瀛洲洞	zh-CN
yongchuanshi	永川市	zh-CN
yongdengpudong	永登浦洞	zh-CN
yongdengpuqu	永登浦区	zh-CN
yongtongjun	永同郡	zh-CN
youdong	佑洞	zh-CN
yuliandong	玉莲洞	zh-CN
yulinli	玉林里	zh-CN
yulingjun	郁陵郡	zh-CN
yuquandong	玉泉洞	zh-CN
yurendong	玉仁洞	zh-CN
yushuidong	玉水洞	zh-CN
yuzhuangshandong	雨装山洞	zh-CN
yuancangdong	元仓洞	zh-CN
yuandangdong	元当洞	zh-CN
yuanli	院里	zh-CN
yuannandong	苑南洞	zh-CN
yuanxidong	苑西洞	zh-CN
yuanxiaolu	元晓路	zh-CN
yuanzhidong	院趾洞	zh-CN
yuanzhoushi	原州市	zh-CN
yuechuanli	月串里	zh-CN
yuegudong	月谷洞	zh-CN
yueneili	月内里	zh-CN
yuepingli	月坪里	zh-CN
yuexidong	月溪洞	zh-CN
yunbeidong	云北洞	zh-CN
yunnandong	云南洞	zh-CN
yunnidong	云泥洞	zh-CN
yunxidong	云西洞	zh-CN
yunyandong	云宴洞	zh-CN
zaisongdong	栽松洞	zh-CN
zaoshanli	造山里	zh-CN
zaoyuandong	枣园洞	zh-CN
zengshandong	缯山洞	zh-CN
zhanghuali	长花里	zh-CN
zhaogedong	昭格洞	zh-CN
zhaoyeli	昭野里	zh-CN
zhenanjun	镇安郡	zh-CN
zhenchuanjun	镇川郡	zh-CN
zhencunli	镇村里	zh-CN
zhendaojun	珍岛郡	zh-CN
zhendong	贞洞	zh-CN
zhenhaishi	镇海市	zh-CN
zhenli	镇里	zh-CN
zhenlingdong	贞陵洞	zh-CN
zhishanli	智山里	zh-CN
zhishidong	智士洞	zh-CN
zhishili	芝石里	zh-CN
zhongbuli	中部里	zh-CN
zhongdong	中洞	zh-CN
zhonggudong	中谷洞	zh-CN
zhonghedong	中和洞	zh-CN
zhonglangqu	中浪区	zh-CN
zhonglindong	中林洞	zh-CN
zhonglu	钟路	zh-CN
zhongluqu	钟路区	zh-CN
zhongqingbeidao	忠清北道	zh-CN
zhongqingnandao	忠清南道	zh-CN
zhongqu	中区	zh-CN
zhongshandong	中山洞	zh-CN
zhongwudong	忠武洞	zh-CN
zhongwulu	忠武路	zh-CN
zhongxibendong	中溪本洞	zh-CN
zhongxidong	中溪洞	zh-CN
zhongxindong	忠信洞	zh-CN
zhongxuedong	中学洞	zh-CN
zhongyandong	钟岩洞	zh-CN
zhongyangdong	中央洞	zh-CN
zhongzhenglu	忠正路	zh-CN
zhongzhoushi	忠州市	zh-CN
zhoulidong	周礼洞	zh-CN
zhouqiaodong	舟桥洞	zh-CN
zhuandong	朱安洞	zh-CN
zhuchengdong	铸城洞	zh-CN
zhuchengli	竹城里	zh-CN
zhudong	苧洞	zh-CN
zhutongdong	竹同洞	zh-CN
zhuwendaoli	注文岛里	zh-CN
zhuzidong	铸字洞	zh-CN
zigudong	紫谷洞	zh-CN
ziyangdong	紫阳洞	zh-CN
ziyueli	紫月里	zh-CN
ziyuemian	紫月面	zh-CN
zuochuandong	佐川洞	zh-CN
zuochuanli	佐川里	zh-CN
zuodong	佐洞	zh-CN
zuodongli	佐东里	zh-CN
