# Gboard Dictionary version:1
aerfa	阿尔法	zh-CN
apaqi	阿帕奇	zh-CN
aibite	爱必特	zh-CN
aidimaisi	爱迪麦斯	zh-CN
aiersha	艾尔莎	zh-CN
aiguozhe	爱国者	zh-CN
aikeji	爱科技	zh-CN
aiken	艾肯	zh-CN
ailing	艾凌	zh-CN
aimosheng	艾默生	zh-CN
aitai	艾泰	zh-CN
aiwai	艾崴	zh-CN
antaike	安泰科	zh-CN
angda	昂达	zh-CN
aoka	奥卡	zh-CN
aokema	澳柯玛	zh-CN
aolinbasi	奥林巴斯	zh-CN
aomai	奥迈	zh-CN
aomeijia	奥美嘉	zh-CN
aoni	奥尼	zh-CN
aosen	傲森	zh-CN
aosika	奥斯卡	zh-CN
aotelanxing	奥特蓝星	zh-CN
babilu	巴比禄	zh-CN
badeshi	霸得世	zh-CN
bainaotong	百脑通	zh-CN
baisheng	百盛	zh-CN
baishide	百事得	zh-CN
baishiling	百事灵	zh-CN
baiyadongli	拜亚动力	zh-CN
baiyu	佰钰	zh-CN
baobai	宝柏	zh-CN
baode	宝德	zh-CN
baolide	保利德	zh-CN
baosheng	宝盛	zh-CN
baowei	宝威	zh-CN
baoyun	宝韵	zh-CN
beierjin	贝尔金	zh-CN
beiouhaidao	北欧海盗	zh-CN
beiqi	贝奇	zh-CN
beitong	北通	zh-CN
benchi	奔驰	zh-CN
bisite	必思特	zh-CN
bodatongxin	博达通信	zh-CN
bodi	博帝	zh-CN
bomeite	博美特	zh-CN
bosheng	博声	zh-CN
caihongling	彩虹翎	zh-CN
changcheng	长城	zh-CN
changting	畅听	zh-CN
chaopinzhe	超频者	zh-CN
chaosheng	超胜	zh-CN
chaowei	超微	zh-CN
chaoxianling	超线灵	zh-CN
chengqi	承启	zh-CN
chongjibo	冲击波	zh-CN
chuangjian	创见	zh-CN
chuangxin	创新	zh-CN
dabaisha	大白鲨	zh-CN
daeryou	达尔优	zh-CN
dashuiniu	大水牛	zh-CN
dayinke	达音科	zh-CN
dazhong	大众	zh-CN
daier	戴尔	zh-CN
deguotanke	德国坦克	zh-CN
diba	迪霸	zh-CN
dilanhengjin	迪兰恒进	zh-CN
dianyuan	电源	zh-CN
dingxing	顶星	zh-CN
dongfangcheng	东方城	zh-CN
dongfangmingzhu	东方明珠	zh-CN
donglixianfeng	动力先锋	zh-CN
donglin	东林	zh-CN
dongyuan	东远	zh-CN
dongzhi	东芝	zh-CN
duocai	多彩	zh-CN
endiya	恩帝亚	zh-CN
fandenghao	范登豪	zh-CN
fanshan	饭山	zh-CN
fangjia	方佳	zh-CN
fangzheng	方正	zh-CN
feilipu	飞利浦	zh-CN
feishimeng	飞仕盟	zh-CN
feiyuxing	飞鱼星	zh-CN
fenda	奋达	zh-CN
fuhao	富豪	zh-CN
fushi	富士	zh-CN
fushikang	富士康	zh-CN
fushishile	富士施乐	zh-CN
fushitong	富士通	zh-CN
gaochuang	高创	zh-CN
gaorui	高锐	zh-CN
gaosi	高斯	zh-CN
geweier	格威尔	zh-CN
gengsheng	耕升	zh-CN
guanmeng	冠盟	zh-CN
guangdian	光电	zh-CN
guangqu	光驱	zh-CN
guojishangyongjiqi	国际商用机器	zh-CN
haidaochuan	海盗船	zh-CN
haier	海尔	zh-CN
hailishi	海力士	zh-CN
hailongdianzicheng	海龙电子城	zh-CN
haitiandi	海天地	zh-CN
haixiao	海啸	zh-CN
hanshiwei	瀚士威	zh-CN
hanwang	汉王	zh-CN
hangjia	航嘉	zh-CN
haofeng	皓峰	zh-CN
haofu	好福	zh-CN
haolaiwu	好莱坞	zh-CN
haoteng	豪腾	zh-CN
haoteng	皓腾	zh-CN
haoxin	浩鑫	zh-CN
hedian	荷电	zh-CN
heijin	黑金	zh-CN
heijingang	黑金刚	zh-CN
heizuan	黑钻	zh-CN
hengli	亨利	zh-CN
hengmei	恒美	zh-CN
hengwei	恒威	zh-CN
hongji	宏基	zh-CN
hongyu	鸿宇	zh-CN
hongzhan	鸿展	zh-CN
houjiajun	厚嘉骏	zh-CN
huaqing	华擎	zh-CN
huasheng	华盛	zh-CN
huashuo	华硕	zh-CN
huawei	华为	zh-CN
huanxiang	幻象	zh-CN
huigu	慧谷	zh-CN
huihai	慧海	zh-CN
huilong	惠隆	zh-CN
huimei	惠美	zh-CN
huipu	惠普	zh-CN
huishijia	惠士嘉	zh-CN
huiwei	惠威	zh-CN
huiyuan	慧源	zh-CN
jidian	极典	zh-CN
jijia	技嘉	zh-CN
jimeng	吉盟	zh-CN
jisu	极速	zh-CN
jizhan	技展	zh-CN
jiabaili	加佰利	zh-CN
jiademei	佳的美	zh-CN
jiadianxiaxiang	家电下乡	zh-CN
jiadun	甲盾	zh-CN
jianji	建基	zh-CN
jianqi	建碁	zh-CN
jianqun	健群	zh-CN
jianxing	建兴	zh-CN
jiebo	捷波	zh-CN
jiejia	捷嘉	zh-CN
jieling	杰灵	zh-CN
jiewei	杰微	zh-CN
jinbang	金邦	zh-CN
jinchangcheng	金长城	zh-CN
jinhetian	金河田	zh-CN
jinkuihua	金葵花	zh-CN
jinlang	金浪	zh-CN
jinming	金铭	zh-CN
jinpin	金品	zh-CN
jinshan	金山	zh-CN
jinshanduba	金山毒霸	zh-CN
jinshanwangdun	金山网盾	zh-CN
jinshigang	金士刚	zh-CN
jinshitai	金士泰	zh-CN
jintaike	金泰克	zh-CN
jinteer	金特尔	zh-CN
jinyong	劲永	zh-CN
jingling	精灵	zh-CN
jingwei	精威	zh-CN
jingxin	晶芯	zh-CN
jingya	精亚	zh-CN
jingying	精英	zh-CN
jufeng	飓风	zh-CN
jueshi	爵士	zh-CN
junxing	隽星	zh-CN
junyi	骏一	zh-CN
kabasiji	卡巴斯基	zh-CN
kangbai	康柏	zh-CN
kangbo	康博	zh-CN
kanghe	康和	zh-CN
kangnengpushi	康能普视	zh-CN
kangshu	康舒	zh-CN
keda	柯达	zh-CN
kediya	科迪亚	zh-CN
keluji	刻录机	zh-CN
keruijia	可瑞加	zh-CN
keruiwo	柯瑞沃	zh-CN
keshida	科士达	zh-CN
kewoda	科沃达	zh-CN
kuke	酷客	zh-CN
kulengzhizun	酷冷至尊	zh-CN
laide	铼德	zh-CN
lanbaoshi	蓝宝石	zh-CN
lanseyaoji	蓝色妖姬	zh-CN
lanxin	兰欣	zh-CN
lanyazhijia	蓝牙之家	zh-CN
langdu	朗度	zh-CN
langkemini	朗科迷你	zh-CN
langsheng	朗胜	zh-CN
langshi	朗视	zh-CN
lezhibang	乐之邦	zh-CN
leibo	雷柏	zh-CN
leike	磊科	zh-CN
leikesha	雷克沙	zh-CN
leishewangxun	雷射网讯	zh-CN
liguang	理光	zh-CN
lijie	力杰	zh-CN
lijing	力晶	zh-CN
limin	利民	zh-CN
lisheng	力胜	zh-CN
litai	丽台	zh-CN
lite	力特	zh-CN
lixiangzhiguang	理想之光	zh-CN
lixun	力迅	zh-CN
lianbao	联宝	zh-CN
lianli	联力	zh-CN
lianxiang	联想	zh-CN
lianzhi	联志	zh-CN
liangtian	良田	zh-CN
liangzi	量子	zh-CN
liehu	猎狐	zh-CN
lingbiao	灵标	zh-CN
lingyi	零壹	zh-CN
longji	龙基	zh-CN
luyouqi	路由器	zh-CN
luodan	罗丹	zh-CN
luoji	罗技	zh-CN
makelaiwensen	马克莱文森	zh-CN
masite	玛思特	zh-CN
maibo	麦博	zh-CN
maidi	迈笛	zh-CN
maikesaier	麦克赛尔	zh-CN
maipu	迈普	zh-CN
maituo	迈拓	zh-CN
maiwei	迈威	zh-CN
manbuzhe	漫步者	zh-CN
meige	美格	zh-CN
meiguang	镁光	zh-CN
meiji	美基	zh-CN
meijiaolong	美蛟龙	zh-CN
meijie	梅捷	zh-CN
meilanrilan	梅兰日兰	zh-CN
meililong	美丽珑	zh-CN
meiqi	美齐	zh-CN
meiruhua	美如画	zh-CN
meishangmei	美上美	zh-CN
meishitong	每时通	zh-CN
mengtian	蒙恬	zh-CN
mengxiangjia	梦想家	zh-CN
mingguan	铭冠	zh-CN
mingji	明基	zh-CN
mingxuan	铭瑄	zh-CN
mingyue	明月	zh-CN
mosu	魔速	zh-CN
moxi	摩西	zh-CN
napusi	纳普斯	zh-CN
nasi	纳思	zh-CN
naweishi	纳伟仕	zh-CN
nanfanggaoke	南方高科	zh-CN
nanfangjinzheng	南方金正	zh-CN
neicun	内存	zh-CN
nengliangzhiyuan	能量之源	zh-CN
nipiao	妮飘	zh-CN
niuman	纽曼	zh-CN
panying	磐英	zh-CN
panzheng	磐正	zh-CN
pinnigao	品尼高	zh-CN
pingguo	苹果	zh-CN
pingguoxingainian	苹果新概念	zh-CN
punuofei	浦诺菲	zh-CN
qicaihong	七彩虹	zh-CN
qiheng	启亨	zh-CN
qike	奇克	zh-CN
qilun	麒仑	zh-CN
qimeng	七盟	zh-CN
qixishuma	七喜数码	zh-CN
qixiang	祺祥	zh-CN
qiangyang	强氧	zh-CN
qiaohai	俏海	zh-CN
qiaowei	侨威	zh-CN
qinmao	勤茂	zh-CN
qinghuaqitian	清华奇天	zh-CN
qinghuatongfang	清华同方	zh-CN
qinghuaziguang	清华紫光	zh-CN
qingqibing	轻骑兵	zh-CN
qingyun	青云	zh-CN
qushi	趋势	zh-CN
quanhan	全汉	zh-CN
quanma	全码	zh-CN
rili	日立	zh-CN
ruijiewangluo	锐捷网络	zh-CN
saibeisi	赛贝思	zh-CN
sainuowei	赛诺威	zh-CN
saitaike	赛钛客	zh-CN
saitian	赛天	zh-CN
sandi	三帝	zh-CN
saner	三尔	zh-CN
sanling	三菱	zh-CN
sannuo	三诺	zh-CN
sanreboshi	散热博士	zh-CN
sanrewang	散热王	zh-CN
sanxing	三星	zh-CN
sangbada	桑巴达	zh-CN
senhaisaier	森海塞尔	zh-CN
sensongni	森松尼	zh-CN
shadu	杀毒	zh-CN
shaduruanjian	杀毒软件	zh-CN
shandun	山顿	zh-CN
shanshui	山水	zh-CN
shante	山特	zh-CN
shangwangben	上网本	zh-CN
shenzhou	神舟	zh-CN
shenzhoushuma	神州数码	zh-CN
shengchuang	胜创	zh-CN
shengdie	晟碟	zh-CN
shengfu	生富	zh-CN
shengji	升技	zh-CN
shengmai	声迈	zh-CN
shidai	世代	zh-CN
shijidaji	世纪大吉	zh-CN
shijiguanjun	世纪冠军	zh-CN
shijizhixing	世纪之星	zh-CN
shipinjiaocheng	视频教程	zh-CN
shiying	视盈	zh-CN
shouhuxing	守护星	zh-CN
shoumai	首迈	zh-CN
shoutong	首通	zh-CN
shuer	舒尔	zh-CN
shuguang	曙光	zh-CN
shuke	数科	zh-CN
shumaduo	数码多	zh-CN
shuangfeiyan	双飞燕	zh-CN
shuangjie	双捷	zh-CN
shuangmin	双敏	zh-CN
shuilengwang	水冷王	zh-CN
shuixing	水星	zh-CN
shuojing	硕菁	zh-CN
shuomeike	硕美科	zh-CN
shuotaike	硕泰克	zh-CN
sibadake	斯巴达克	zh-CN
sihua	思华	zh-CN
sike	思科	zh-CN
simin	思民	zh-CN
sitong	四通	zh-CN
siwei	思维	zh-CN
songxia	松下	zh-CN
suoni	索尼	zh-CN
suowei	索威	zh-CN
taian	泰安	zh-CN
taida	台达	zh-CN
taidian	台电	zh-CN
taiji	跆基	zh-CN
taixun	台讯	zh-CN
taiyanghua	太阳花	zh-CN
tengda	腾达	zh-CN
tianlang	天朗	zh-CN
tianmin	天敏	zh-CN
tianpu	田浦	zh-CN
tianwei	天威	zh-CN
tianyawufeng	天涯无风	zh-CN
tongfangguangpan	同方光盘	zh-CN
tongwei	同维	zh-CN
tulang	土狼	zh-CN
wanli	万丽	zh-CN
wannuo	万诺	zh-CN
wangda	网达	zh-CN
wangjian	网件	zh-CN
wangxing	网星	zh-CN
weibao	威宝	zh-CN
weier	微尔	zh-CN
weigang	威刚	zh-CN
weige	唯歌	zh-CN
weike	微克	zh-CN
weilaizhanshi	未来战士	zh-CN
weiruan	微软	zh-CN
weisheng	威盛	zh-CN
weisheng	微昇	zh-CN
weitong	威通	zh-CN
weiwang	维网	zh-CN
weixing	微星	zh-CN
weixun	伟训	zh-CN
weizi	微子	zh-CN
wenming	文明	zh-CN
wuzhou	五舟	zh-CN
xiba	西霸	zh-CN
xibushuju	西部数据	zh-CN
xijie	希捷	zh-CN
xishi	希仕	zh-CN
xianuo	侠诺	zh-CN
xiaxin	夏新	zh-CN
xiandai	现代	zh-CN
xianfeng	先锋	zh-CN
xianka	显卡	zh-CN
xianma	先马	zh-CN
xianshiqi	显示器	zh-CN
xiangjiao	香蕉	zh-CN
xiangsheng	翔升	zh-CN
xiaodaishu	小袋鼠	zh-CN
xiaoyingba	小影霸	zh-CN
xinbada	辛巴达	zh-CN
xingu	鑫谷	zh-CN
xinguandian	新观点	zh-CN
xingui	新贵	zh-CN
xinju	新巨	zh-CN
xinke	新科	zh-CN
xinshi	信实	zh-CN
xinsilu	新思路	zh-CN
xintai	新泰	zh-CN
xinxiang	欣向	zh-CN
xingcun	星存	zh-CN
xingying	星盈	zh-CN
xingyuquan	星宇泉	zh-CN
xunjie	迅捷	zh-CN
xunjing	讯景	zh-CN
xuntuo	讯拓	zh-CN
xunyi	讯宜	zh-CN
yabao	雅宝	zh-CN
yahu	雅虎	zh-CN
yalanshi	雅兰仕	zh-CN
yamaha	雅马哈	zh-CN
yase	亚瑟	zh-CN
yetian	冶天	zh-CN
yibao	忆宝	zh-CN
yicun	易存	zh-CN
yidian	艺电	zh-CN
yike	意科	zh-CN
yimeixun	易美逊	zh-CN
yishikong	亿时空	zh-CN
yituo	易拓	zh-CN
yizhuo	艺卓	zh-CN
yintemei	音特美	zh-CN
yinxin	银欣	zh-CN
yingchi	影驰	zh-CN
yingfeiling	英飞凌	zh-CN
yingjia	盈佳	zh-CN
yingmai	英迈	zh-CN
yingmei	映美	zh-CN
yingpai	映派	zh-CN
yingpan	硬盘	zh-CN
yingshidiguo	影视帝国	zh-CN
yingtai	鹰泰	zh-CN
yingtai	映泰	zh-CN
yingteer	英特尔	zh-CN
yingtong	盈通	zh-CN
yingyindashi	影音大师	zh-CN
yongyang	永阳	zh-CN
youji	友基	zh-CN
youkang	友康	zh-CN
youli	友立	zh-CN
youpai	优派	zh-CN
youtai	佑泰	zh-CN
youze	佑泽	zh-CN
yuxin	禹信	zh-CN
yuzhan	宇瞻	zh-CN
yuangang	圆刚	zh-CN
yuanju	元聚	zh-CN
yuanxing	源兴	zh-CN
yuehaiyangbo	越海扬波	zh-CN
zezhi	泽志	zh-CN
zhentiankeji	震天科技	zh-CN
zhengrui	正睿	zh-CN
zhida	至达	zh-CN
zhimei	志美	zh-CN
zhiming	致铭	zh-CN
zhiqi	芝奇	zh-CN
zhirong	致荣	zh-CN
zhixiang	智翔	zh-CN
zhongbao	中宝	zh-CN
zhongguancun	中关村	zh-CN
zhonghuan	中环	zh-CN
zhongjiezhe	终结者	zh-CN
zhongxing	中兴	zh-CN
zhongyishukuan	中怡数宽	zh-CN
zhuban	主板	zh-CN
zhuomuniao	啄木鸟	zh-CN
zuanshi	钻石	zh-CN
zuoni	佐尼	zh-CN
