# Gboard Dictionary version:1
baokuoduizhongzu	包括对种族	zh-CN
baokuole	包括了	zh-CN
baokuolishi	包括历史	zh-CN
baokuoxiang	包括像	zh-CN
biandeyuelaiyue	变得越来越	zh-CN
bingbutansuo	并不探索	zh-CN
caiqude	采取的	zh-CN
canyuguancha	参与观察	zh-CN
changdaode	倡导的	zh-CN
chengshishehuixue	城市社会学	zh-CN
chengyuancunzai	成员存在	zh-CN
chuxianyu	出现于	zh-CN
congbuxunqiuyou	从不寻求有	zh-CN
congerjianli	从而建立	zh-CN
congerzuochujiuzheng	从而作出纠正	zh-CN
congguoqu	从过去	zh-CN
congshuliangshang	从数量上	zh-CN
danquekeyi	但却可以	zh-CN
daoxiru	到细如	zh-CN
debufen	的部分	zh-CN
deduili	的对立	zh-CN
defangfa	的方法	zh-CN
deguannian	的观念	zh-CN
deguanxi	的关系	zh-CN
deguoshehuixue	德国社会学	zh-CN
dehuiying	的回应	zh-CN
dejiuzhi	的救治	zh-CN
dekexue	的科学	zh-CN
delida	德里达	zh-CN
delingwaiyige	的另外一个	zh-CN
deqiyuan	的起源	zh-CN
deshenshang	的身上	zh-CN
dexueke	的学科	zh-CN
deyanjiufangxiang	的研究方向	zh-CN
deyuantou	的源头	zh-CN
dijingli	地经历	zh-CN
dinglianghedingxing	定量和定性	zh-CN
dingliangmoxing	定量模型	zh-CN
dingliangyanjiu	定量研究	zh-CN
dingxingfenxi	定性分析	zh-CN
dingxingyanjiu	定性研究	zh-CN
dingxingziliao	定性资料	zh-CN
duhuiyizhi	都会一致	zh-CN
dutefangshi	独特方式	zh-CN
dutexingderenwen	独特性的人文	zh-CN
duishehui	对社会	zh-CN
erbushimaodunde	而不是矛盾的	zh-CN
ershizuoweiyige	而是作为一个	zh-CN
faguoshehuixue	法国社会学	zh-CN
falankefuxuepai	法兰克福学派	zh-CN
famingle	发明了	zh-CN
fazhanguilv	发展规律	zh-CN
fazhanguocheng	发展过程	zh-CN
fazhanhe	发展和	zh-CN
fanzuihelihun	犯罪和离婚	zh-CN
fangfalai	方法来	zh-CN
fangfalunzhiyi	方法论之一	zh-CN
fenchenggengduogengxi	分成更多更细	zh-CN
fenxifangfa	分析方法	zh-CN
fengsuxiguan	风俗习惯	zh-CN
gerende	个人的	zh-CN
gerenshehuiguanximoshi	个人社会关系模式	zh-CN
getichayixing	个体差异性	zh-CN
gezisuo	各自所	zh-CN
genghaodefangfa	更好的方法	zh-CN
gengxiwang	更希望	zh-CN
guandianrenwei	观点认为	zh-CN
guizekaoyan	规则考验	zh-CN
habeimasi	哈贝马斯	zh-CN
haihuishiwentijiazhong	还会使问题加重	zh-CN
hefensan	和分散	zh-CN
herenmen	和人们	zh-CN
hengkuajingji	横跨经济	zh-CN
hongguanjiegou	宏观结构	zh-CN
huxiangjiejian	互相借鉴	zh-CN
huxiangxinshang	互相欣赏	zh-CN
hunhele	混合了	zh-CN
jigoude	机构的	zh-CN
jizhexue	及哲学	zh-CN
jiatingjiegou	家庭结构	zh-CN
jiejihexingbie	阶级和性别	zh-CN
jiejuebuliaowenti	解决不了问题	zh-CN
jieranbutong	截然不同	zh-CN
jingdeqikexue	经得起科学	zh-CN
jiuzhifangan	救治方案	zh-CN
jujiqilai	聚集起来	zh-CN
juedaduoshuren	绝大多数人	zh-CN
keyijiaqianglijie	可以加强理解	zh-CN
keyiyujian	可以预见	zh-CN
kongde	孔德	zh-CN
lazhasifeierde	拉扎斯费尔德	zh-CN
laichenghuzhege	来称呼这个	zh-CN
laimiaoshu	来描述	zh-CN
laiyanjiu	来研究	zh-CN
laonianshehuixue	老年社会学	zh-CN
liaota	利奥塔	zh-CN
liluntedian	理论特点	zh-CN
liruyou	例如有	zh-CN
lisanxingdeshehui	离散性的社会	zh-CN
lishijixinlixue	历史及心理学	zh-CN
lishijieduan	历史阶段	zh-CN
liaojieshehui	了解社会	zh-CN
liupaishi	流派是	zh-CN
neirongfenxi	内容分析	zh-CN
nongcunshehuixue	农村社会学	zh-CN
qitapaibie	其他派别	zh-CN
qiangjiadao	强加到	zh-CN
qingxiangbianwei	倾向变为	zh-CN
quebiande	却变得	zh-CN
quntihuo	群体或	zh-CN
renleishehui	人类社会	zh-CN
renleixue	人类学	zh-CN
renleizhishi	人类知识	zh-CN
renmenbushi	人们不是	zh-CN
renweidui	认为对	zh-CN
renwenlingyu	人文领域	zh-CN
renwenxueke	人文学科	zh-CN
renyurenzhijian	人与人之间	zh-CN
ruguoyige	如果一个	zh-CN
shehuibianqian	社会变迁	zh-CN
shehuibianqianfanying	社会变迁反应	zh-CN
shehuibingji	社会病疾	zh-CN
shehuidejiegou	社会的结构	zh-CN
shehuideyanjiu	社会的研究	zh-CN
shehuigongzuo	社会工作	zh-CN
shehuiguanxi	社会关系	zh-CN
shehuikexue	社会科学	zh-CN
shehuikexuezhongyu	社会科学终于	zh-CN
shehuikeyi	社会可以	zh-CN
shehuituanti	社会团体	zh-CN
shehuiwulixue	社会物理学	zh-CN
shehuixingwei	社会行为	zh-CN
shehuixue	社会学	zh-CN
shehuixuefenzhi	社会学分支	zh-CN
shehuixuejiabudan	社会学家不但	zh-CN
shehuixuejiadui	社会学家对	zh-CN
shehuixuejiahaichangyong	社会学家还常用	zh-CN
shehuixuejiaxiangxin	社会学家相信	zh-CN
shehuixuelilun	社会学理论	zh-CN
shehuixuelinian	社会学理念	zh-CN
shehuixueshi	社会学是	zh-CN
shehuixuexi	社会学系	zh-CN
shehuixuexuepai	社会学学派	zh-CN
shehuixueyanjiu	社会学研究	zh-CN
shehuixueyanjiufangfa	社会学研究方法	zh-CN
shehuixueyici	社会学一词	zh-CN
shehuixueyu	社会学与	zh-CN
shehuixuezhong	社会学中	zh-CN
shehuixuezhuti	社会学主题	zh-CN
shehuixuezhuyaorenwu	社会学主要人物	zh-CN
shehuixuezuowei	社会学作为	zh-CN
shehuiyanjiufangfa	社会研究方法	zh-CN
shehuizhengti	社会整体	zh-CN
shehuizhongde	社会中的	zh-CN
shehuizuzhi	社会组织	zh-CN
shendufangtan	深度访谈	zh-CN
shenmeshide	什么使得	zh-CN
shidianxing	是典型	zh-CN
shihubude	是互补的	zh-CN
shijide	世纪的	zh-CN
shijiejingyan	世界经验	zh-CN
shiyongyizhong	使用一种	zh-CN
shouchuangde	首创的	zh-CN
shoujiziliao	收集资料	zh-CN
suochideguandian	所持的观点	zh-CN
suoyourenleihuodong	所有人类活动	zh-CN
tadegongxian	他的贡献	zh-CN
tadeyiyi	它的意义	zh-CN
tashide	他使得	zh-CN
tashitu	他试图	zh-CN
taxiangxin	他相信	zh-CN
tichude	提出的	zh-CN
tongyisuoyoude	统一所有的	zh-CN
tuchumaodun	突出矛盾	zh-CN
tuerganxuepai	涂尔干学派	zh-CN
tuantixingxingwei	团体性行为	zh-CN
tuolile	脱离了	zh-CN
wajiede	瓦解的	zh-CN
waibulianjie	外部链接	zh-CN
wangwangshi	往往是	zh-CN
weiguanxingwei	微观行为	zh-CN
wulixuede	物理学的	zh-CN
xiwangliaojie	希望了解	zh-CN
xiandaishehuide	现代社会的	zh-CN
xiandaixing	现代性	zh-CN
xiandaixingmaodun	现代性矛盾	zh-CN
xianzaishi	现在是	zh-CN
xiaohe	小和	zh-CN
xiaoqunti	小群体	zh-CN
xindexueke	新的学科	zh-CN
xinlihejingjixue	心理和经济学	zh-CN
xueshufanchou	学术范畴	zh-CN
xueshufengge	学术风格	zh-CN
yanjiufangfa	研究方法	zh-CN
yicilaiyanjiu	以此来研究	zh-CN
yicishiyou	一词是由	zh-CN
yigeshehui	一个社会	zh-CN
yigezhengti	一个整体	zh-CN
yijijiyu	以及基于	zh-CN
yimenxinde	一门新的	zh-CN
yixiliede	一系列的	zh-CN
yiyanjiu	以研究	zh-CN
yiyige	以一个	zh-CN
yizhiguandian	一致观点	zh-CN
yinweitamen	因为他们	zh-CN
yinweizhe	因为这	zh-CN
youguanwenxian	有关文献	zh-CN
yushuxue	与数学	zh-CN
yuanbentayong	原本他用	zh-CN
yuanhuayu	元话语	zh-CN
yuelaiyuechengwei	越来越成为	zh-CN
yuelaiyuefenlie	越来越分裂	zh-CN
zaishehuixuezhong	在社会学中	zh-CN
zaiweiguanfangmian	在微观方面	zh-CN
zaiyuxunzhao	在于寻找	zh-CN
zhagenlilun	扎根理论	zh-CN
zhebudan	这不但	zh-CN
zhegeshijie	这个世界	zh-CN
zheliangzhongyanjiufangshi	这两种研究方式	zh-CN
zheshiyizhong	这是一种	zh-CN
zhezhongfangfa	这种方法	zh-CN
zhezhongguandian	这种观点	zh-CN
zhezhongyou	这种由	zh-CN
zhongdezhuyao	中的主要	zh-CN
zhuliude	主流的	zh-CN
zhuyaode	主要的	zh-CN
zhuyaoxueshuo	主要学说	zh-CN
zhuyaoyanjiu	主要研究	zh-CN
zhuazhezhegejieduan	抓着这个阶段	zh-CN
zhuantixiaozutaolun	专题小组讨论	zh-CN
zonghexingxueke	综合性学科	zh-CN
zongtijiegou	总体结构	zh-CN
zongtipubianxing	总体普遍性	zh-CN
zuzhixinghuozhe	组织性或者	zh-CN
zuoweigeti	作为个体	zh-CN
